Rk,Date,Tm,â–¾,Opp,Result,MP,FG,FGA,FG%,2P,2PA,2P%,3P,3PA,3P%,FT,FTA,FT%,PTS,FG,FGA,FG%,2P,2PA,2P%,3P,3PA,3P%,FT,FTA,FT%,PTS
1,2012-11-12,UTA,@,TOR,W 140-133
,315,46,93,.495,32,67,.478,14,26,.538,34,43,.791,140,51,108,.472,43,84,.512,8,24,.333,23,30,.767,133
2,2013-03-08,POR,@,SAS,W 136-106,240,53,86,.616,40,65,.615,13,21,.619,17,21,.810,136,44,84,.524,38,65,.585,6,19,.316,12,15,.800,106
3,2012-12-10,SAS,@,HOU,W 134-126,265,48,92,.522,34,62,.548,14,30,.467,24,26,.923,134,41,97,.423,25,67,.373,16,30,.533,28,36,.778,126
4,2012-12-08,SAS,@,CHA,W 132-102,240,50,90,.556,31,56,.554,19,34,.559,13,15,.867,132,37,79,.468,31,64,.484,6,15,.400,22,31,.710,102
5,2013-02-26,SAC,@,MIA,L 129-141,290,48,93,.516,34,66,.515,14,27,.519,19,26,.731,129,56,101,.554,46,78,.590,10,23,.435,19,24,.792,141
6,2013-01-12,MIA,@,SAC,W 128-99,240,45,80,.563,28,43,.651,17,37,.459,21,24,.875,128,38,87,.437,29,69,.420,9,18,.500,14,19,.737,99
7,2012-12-19,GSW,@,SAC,L 127-131,240,46,92,.500,33,66,.500,13,26,.500,22,25,.880,127,43,86,.500,32,67,.478,11,19,.579,34,42,.810,131
8,2013-03-18,DAL,@,ATL,W 127-113,240,51,89,.573,38,67,.567,13,22,.591,12,14,.857,127,42,75,.560,34,54,.630,8,21,.381,21,29,.724,113
9,2013-01-28,HOU,@,UTA,W 125-80,240,47,89,.528,31,55,.564,16,34,.471,15,18,.833,125,32,81,.395,27,63,.429,5,18,.278,11,19,.579,80
10,2013-02-14,LAC,@,LAL,W 125-101,240,46,89,.517,30,59,.508,16,30,.533,17,22,.773,125,38,75,.507,32,55,.582,6,20,.300,19,27,.704,101
11,2013-02-27,SAC,@,ORL,W 125-101,240,46,84,.548,36,62,.581,10,22,.455,23,29,.793,125,37,83,.446,31,64,.484,6,19,.316,21,25,.840,101
12,2013-04-07,NYK,@,OKC,W 125-120,240,46,93,.495,31,59,.525,15,34,.441,18,24,.750,125,45,78,.577,36,61,.590,9,17,.529,21,25,.840,120
13,2012-12-29,OKC,@,HOU,W 124-94,240,45,94,.479,32,65,.492,13,29,.448,21,23,.913,124,33,83,.398,25,53,.472,8,30,.267,20,27,.741,94
14,2013-04-10,ATL,@,PHI,W 124-101,240,49,91,.538,41,69,.594,8,22,.364,18,19,.947,124,37,88,.420,30,67,.448,7,21,.333,20,22,.909,101
15,2012-12-29,TOR,@,ORL,W 123-88,240,46,82,.561,31,55,.564,15,27,.556,16,21,.762,123,36,81,.444,31,63,.492,5,18,.278,11,22,.500,88
16,2012-12-16,DEN,@,SAC,W 122-97,240,46,85,.541,38,67,.567,8,18,.444,22,29,.759,122,31,91,.341,25,67,.373,6,24,.250,29,34,.853,97
17,2012-12-25,HOU,@,CHI,W 120-97,240,46,82,.561,38,62,.613,8,20,.400,20,24,.833,120,37,83,.446,31,63,.492,6,20,.300,17,20,.850,97
18,2013-03-05,DEN,@,SAC,W 120-113,240,46,85,.541,38,69,.551,8,16,.500,20,32,.625,120,39,85,.459,27,54,.500,12,31,.387,23,28,.821,113
19,2013-03-27,LAL,@,MIN,W 120-117,240,44,82,.537,34,60,.567,10,22,.455,22,38,.579,120,45,97,.464,40,80,.500,5,17,.294,22,30,.733,117
20,2013-04-13,BOS,@,ORL,W 120-88,240,48,81,.593,38,65,.585,10,16,.625,14,19,.737,120,35,83,.422,30,69,.435,5,14,.357,13,15,.867,88
21,2012-12-26,DET,@,ATL,L 119-126,290,48,109,.440,34,82,.415,14,27,.519,9,15,.600,119,46,98,.469,35,65,.538,11,33,.333,23,31,.742,126
22,2013-01-07,ORL,@,POR,L 119-125,265,46,93,.495,35,63,.556,11,30,.367,16,18,.889,119,48,94,.511,40,70,.571,8,24,.333,21,24,.875,125
23,2013-02-20,OKC,@,HOU,L 119-122,240,42,87,.483,31,59,.525,11,28,.393,24,27,.889,119,44,92,.478,29,59,.492,15,33,.455,19,23,.826,122
24,2013-03-18,DEN,@,CHI,W 119-118,265,46,100,.460,39,80,.488,7,20,.350,20,27,.741,119,47,96,.490,39,75,.520,8,21,.381,16,19,.842,118
1,2013-03-18,BRK,@,DET,W 119-82,240,45,83,.542,36,62,.581,9,21,.429,20,23,.870,119,34,78,.436,33,60,.550,1,18,.056,13,15,.867,82
2,2012-11-26,SAS,@,WAS,W 118-92,240,45,80,.563,32,57,.561,13,23,.565,15,20,.750,118,37,90,.411,33,76,.434,4,14,.286,14,17,.824,92
3,2012-12-01,POR,@,CLE,W 118-117,290,46,94,.489,37,69,.536,9,25,.360,17,21,.810,118,43,99,.434,30,64,.469,13,35,.371,18,22,.818,117
4,2012-12-03,POR,@,CHA,W 118-112,265,43,92,.467,31,57,.544,12,35,.343,20,26,.769,118,41,88,.466,28,61,.459,13,27,.481,17,22,.773,112
5,2012-12-22,LAL,@,GSW,W 118-115,265,49,107,.458,40,80,.500,9,27,.333,11,14,.786,118,46,103,.447,36,74,.486,10,29,.345,13,15,.867,115
6,2013-01-14,CLE,@,SAC,L 118-124,240,44,92,.478,36,76,.474,8,16,.500,22,30,.733,118,43,84,.512,34,65,.523,9,19,.474,29,33,.879,124
7,2013-01-20,OKC,@,DEN,L 118-121,265,35,76,.461,27,52,.519,8,24,.333,40,48,.833,118,45,93,.484,37,75,.493,8,18,.444,23,34,.676,121
8,2013-02-23,CLE,@,ORL,W 118-94,240,43,87,.494,34,66,.515,9,21,.429,23,28,.821,118,38,79,.481,34,65,.523,4,14,.286,14,22,.636,94
9,2013-03-01,HOU,@,ORL,W 118-110,240,42,77,.545,27,45,.600,15,32,.469,19,28,.679,118,44,78,.564,35,56,.625,9,22,.409,13,16,.813,110
10,2013-03-04,TOR,@,GSW,L 118-125,240,41,94,.436,32,68,.471,9,26,.346,27,35,.771,118,47,82,.573,39,65,.600,8,17,.471,23,28,.821,125
11,2012-11-07,PHO,@,CHA,W 117-110,240,43,93,.462,31,66,.470,12,27,.444,19,28,.679,117,38,87,.437,28,65,.431,10,22,.455,24,27,.889,110
12,2012-11-16,HOU,@,POR,L 117-119,265,41,88,.466,32,63,.508,9,25,.360,26,31,.839,117,44,86,.512,34,61,.557,10,25,.400,21,29,.724,119
13,2012-12-04,OKC,@,BRK,W 117-111,240,40,66,.606,33,52,.635,7,14,.500,30,34,.882,117,39,91,.429,25,57,.439,14,34,.412,19,23,.826,111
14,2012-12-09,UTA,@,LAL,W 117-110,240,45,83,.542,39,65,.600,6,18,.333,21,27,.778,117,40,85,.471,25,57,.439,15,28,.536,15,18,.833,110
15,2013-01-02,SAS,@,MIL,W 117-110,240,46,89,.517,37,72,.514,9,17,.529,16,23,.696,117,43,88,.489,38,71,.535,5,17,.294,19,24,.792,110
16,2013-01-10,DAL,@,SAC,W 117-112,265,41,96,.427,36,75,.480,5,21,.238,30,35,.857,117,40,81,.494,33,54,.611,7,27,.259,25,32,.781,112
17,2013-01-15,LAC,@,HOU,W 117-109,240,42,78,.538,31,59,.525,11,19,.579,22,26,.846,117,41,82,.500,28,45,.622,13,37,.351,14,25,.560,109
18,2013-01-18,OKC,@,DAL,W 117-114,265,39,95,.411,33,75,.440,6,20,.300,33,36,.917,117,41,91,.451,34,71,.479,7,20,.350,25,30,.833,114
19,2013-01-29,MIL,@,DET,W 117-90,240,46,98,.469,35,75,.467,11,23,.478,14,22,.636,117,34,84,.405,32,73,.438,2,11,.182,20,28,.714,90
20,2013-03-22,MIN,@,PHO,W 117-86,240,42,79,.532,40,67,.597,2,12,.167,31,40,.775,117,36,95,.379,32,73,.438,4,22,.182,10,21,.476,86
21,2013-03-24,PHI,@,SAC,W 117-103,240,47,96,.490,39,75,.520,8,21,.381,15,21,.714,117,42,85,.494,33,61,.541,9,24,.375,10,12,.833,103
22,2013-03-28,SAC,@,PHO,W 117-103,240,44,83,.530,37,65,.569,7,18,.389,22,24,.917,117,42,94,.447,35,74,.473,7,20,.350,12,23,.522,103
23,2013-04-05,DAL,@,SAC,W 117-108,240,46,90,.511,40,70,.571,6,20,.300,19,19,1.000,117,39,87,.448,33,61,.541,6,26,.231,24,31,.774,108
24,2013-04-12,BRK,@,IND,W 117-109,240,42,82,.512,30,57,.526,12,25,.480,21,26,.808,117,40,80,.500,32,61,.525,8,19,.421,21,26,.808,109
25,2012-11-03,DEN,@,MIA,L 116-119,240,49,95,.516,44,74,.595,5,21,.238,13,20,.650,116,43,83,.518,33,58,.569,10,25,.400,23,27,.852,119
26,2012-11-24,OKC,@,PHI,W 116-109,265,39,88,.443,33,67,.493,6,21,.286,32,37,.865,116,45,91,.495,38,71,.535,7,20,.350,12,17,.706,109
27,2012-11-25,BOS,@,ORL,W 116-110,265,47,105,.448,40,87,.460,7,18,.389,15,19,.789,116,41,90,.456,30,64,.469,11,26,.423,17,19,.895,110
28,2012-12-01,UTA,@,HOU,L 116-124,240,48,94,.511,37,74,.500,11,20,.550,9,11,.818,116,46,83,.554,35,61,.574,11,22,.500,21,26,.808,124
29,2012-12-08,DAL,@,HOU,W 116-109,240,43,91,.473,33,67,.493,10,24,.417,20,25,.800,116,35,72,.486,23,37,.622,12,35,.343,27,38,.711,109
30,2012-12-28,HOU,@,SAS,L 116-122,240,45,86,.523,34,54,.630,11,32,.344,15,26,.577,116,44,77,.571,32,54,.593,12,23,.522,22,24,.917,122
31,2012-12-28,LAC,@,UTA,W 116-114,240,38,77,.494,31,54,.574,7,23,.304,33,41,.805,116,34,71,.479,25,56,.446,9,15,.600,37,40,.925,114
32,2013-01-11,OKC,@,LAL,W 116-101,240,44,87,.506,35,58,.603,9,29,.310,19,28,.679,116,39,98,.398,33,70,.471,6,28,.214,17,22,.773,101
33,2013-01-19,GSW,@,NOH,W 116-112,240,38,77,.494,28,55,.509,10,22,.455,30,35,.857,116,45,79,.570,36,55,.655,9,24,.375,13,23,.565,112
34,2013-01-23,TOR,@,MIA,L 116-123,265,44,88,.500,30,57,.526,14,31,.452,14,18,.778,116,45,82,.549,36,60,.600,9,22,.409,24,38,.632,123
35,2013-02-12,HOU,@,GSW,W 116-107,240,43,91,.473,33,57,.579,10,34,.294,20,25,.800,116,38,84,.452,30,64,.469,8,20,.400,23,31,.742,107
36,2013-02-21,SAS,@,LAC,W 116-90,240,43,73,.589,35,56,.625,8,17,.471,22,28,.786,116,32,76,.421,27,60,.450,5,16,.313,21,25,.840,90
37,2013-03-08,OKC,@,CHA,W 116-94,240,46,81,.568,34,57,.596,12,24,.500,12,16,.750,116,35,85,.412,28,62,.452,7,23,.304,17,25,.680,94
38,2013-03-08,TOR,@,LAL,L 116-118,265,48,93,.516,40,71,.563,8,22,.364,12,16,.750,116,39,91,.429,25,52,.481,14,39,.359,26,36,.722,118
39,2013-04-05,HOU,@,POR,W 116-98,240,39,76,.513,27,48,.563,12,28,.429,26,35,.743,116,38,91,.418,36,71,.507,2,20,.100,20,24,.833,98
40,2013-04-11,OKC,@,GSW,W 116-97,240,42,83,.506,30,56,.536,12,27,.444,20,23,.870,116,37,84,.440,30,68,.441,7,16,.438,16,26,.615,97
41,2013-04-12,GSW,@,LAL,L 116-118,240,46,97,.474,35,71,.493,11,26,.423,13,16,.813,116,34,66,.515,22,41,.537,12,25,.480,38,50,.760,118
42,2012-11-02,CHI,@,CLE,W 115-86,240,44,69,.638,40,59,.678,4,10,.400,23,30,.767,115,32,79,.405,24,59,.407,8,20,.400,14,27,.519,86
43,2012-11-24,LAL,@,DAL,W 115-89,240,40,82,.488,28,60,.467,12,22,.545,23,34,.676,115,34,92,.370,24,64,.375,10,28,.357,11,20,.550,89
44,2012-12-12,DAL,@,BOS,L 115-117,290,47,92,.511,39,69,.565,8,23,.348,13,17,.765,115,43,100,.430,37,78,.474,6,22,.273,25,30,.833,117
45,2012-12-15,GSW,@,ATL,W 115-93,240,49,99,.495,39,75,.520,10,24,.417,7,8,.875,115,31,84,.369,26,58,.448,5,26,.192,26,36,.722,93
46,2013-01-04,HOU,@,MIL,W 115-101,240,45,83,.542,32,50,.640,13,33,.394,12,19,.632,115,39,87,.448,33,73,.452,6,14,.429,17,23,.739,101
47,2013-01-04,BRK,@,WAS,W 115-113,290,41,89,.461,33,65,.508,8,24,.333,25,36,.694,115,43,91,.473,34,73,.466,9,18,.500,18,31,.581,113
48,2013-03-08,IND,@,ORL,W 115-86,240,43,83,.518,32,64,.500,11,19,.579,18,23,.783,115,32,82,.390,27,67,.403,5,15,.333,17,19,.895,86
49,2013-03-10,MIL,@,SAC,W 115-113,240,40,87,.460,33,68,.485,7,19,.368,28,38,.737,115,44,94,.468,38,72,.528,6,22,.273,19,25,.760,113
50,2013-03-12,DAL,@,MIL,W 115-108,240,41,82,.500,30,53,.566,11,29,.379,22,27,.815,115,43,89,.483,35,68,.515,8,21,.381,14,17,.824,108
1,2012-11-03,GSW,@,LAC,W 114-110,240,41,84,.488,37,68,.544,4,16,.250,28,39,.718,114,30,70,.429,20,49,.408,10,21,.476,40,52,.769,110
2,2012-12-26,LAL,@,DEN,L 114-126,240,41,83,.494,30,54,.556,11,29,.379,21,30,.700,114,45,94,.479,33,72,.458,12,22,.545,24,32,.750,126
3,2013-01-05,NYK,@,ORL,W 114-106,240,42,88,.477,30,55,.545,12,33,.364,18,22,.818,114,41,85,.482,31,59,.525,10,26,.385,14,18,.778,106
4,2013-01-28,GSW,@,TOR,W 114-102,240,46,86,.535,40,71,.563,6,15,.400,16,20,.800,114,38,87,.437,32,68,.471,6,19,.316,20,23,.870,102
5,2013-02-10,DEN,@,BOS,L 114-118,315,48,113,.425,40,87,.460,8,26,.308,10,17,.588,114,43,108,.398,30,78,.385,13,30,.433,19,24,.792,118
6,2013-02-23,MIA,@,PHI,W 114-90,240,45,77,.584,36,56,.643,9,21,.429,15,18,.833,114,35,78,.449,24,50,.480,11,28,.393,9,10,.900,90
7,2013-02-25,ATL,@,DET,W 114-103,240,40,79,.506,26,46,.565,14,33,.424,20,24,.833,114,41,84,.488,38,70,.543,3,14,.214,18,22,.818,103
8,2013-03-02,TOR,@,MIL,L 114-122,265,46,100,.460,38,78,.487,8,22,.364,14,18,.778,114,46,92,.500,41,78,.526,5,14,.357,25,30,.833,122
9,2013-03-18,WAS,@,CHA,L 114-119,240,43,81,.531,37,66,.561,6,15,.400,22,29,.759,114,42,79,.532,33,57,.579,9,22,.409,26,33,.788,119
10,2013-03-19,DEN,@,OKC,W 114-104,240,43,96,.448,39,75,.520,4,21,.190,24,29,.828,114,37,85,.435,33,60,.550,4,25,.160,26,31,.839,104
11,2013-04-06,HOU,@,DEN,L 114-132,240,39,83,.470,25,49,.510,14,34,.412,22,32,.688,114,54,99,.545,43,74,.581,11,25,.440,13,21,.619,132
12,2012-11-12,MIA,@,HOU,W 113-110,240,45,89,.506,35,68,.515,10,21,.476,13,20,.650,113,36,80,.450,24,46,.522,12,34,.353,26,33,.788,110
13,2012-11-17,NOH,@,MIL,L 113-117,240,41,77,.532,31,56,.554,10,21,.476,21,22,.955,113,43,93,.462,30,68,.441,13,25,.520,18,24,.750,117
14,2012-11-30,CLE,@,ATL,W 113-111,240,41,85,.482,31,62,.500,10,23,.435,21,22,.955,113,38,78,.487,26,58,.448,12,20,.600,23,32,.719,111
15,2012-12-02,ORL,@,LAL,W 113-103,240,43,86,.500,35,63,.556,8,23,.348,19,20,.950,113,36,86,.419,30,69,.435,6,17,.353,25,39,.641,103
16,2012-12-14,MIN,@,NOH,W 113-102,240,47,88,.534,40,71,.563,7,17,.412,12,17,.706,113,42,78,.538,31,54,.574,11,24,.458,7,10,.700,102
17,2012-12-18,TOR,@,CLE,W 113-99,240,39,75,.520,27,51,.529,12,24,.500,23,27,.852,113,36,70,.514,29,54,.537,7,16,.438,20,30,.667,99
18,2013-01-07,MEM,@,SAC,W 113-81,240,39,80,.488,28,60,.467,11,20,.550,24,27,.889,113,28,76,.368,23,55,.418,5,21,.238,20,23,.870,81
19,2013-01-25,SAS,@,DAL,W 113-107,240,43,89,.483,34,66,.515,9,23,.391,18,24,.750,113,42,91,.462,36,73,.493,6,18,.333,17,18,.944,107
20,2013-02-22,BOS,@,PHO,W 113-88,240,44,79,.557,34,57,.596,10,22,.455,15,23,.652,113,35,84,.417,31,65,.477,4,19,.211,14,23,.609,88
21,2013-02-22,DEN,@,WAS,L 113-119,240,39,81,.481,35,59,.593,4,22,.182,31,37,.838,113,42,88,.477,31,64,.484,11,24,.458,24,33,.727,119
22,2013-02-23,DEN,@,CHA,W 113-99,240,44,83,.530,37,64,.578,7,19,.368,18,22,.818,113,37,82,.451,35,71,.493,2,11,.182,23,30,.767,99
23,2013-03-15,CHI,@,GSW,W 113-95,240,43,83,.518,35,67,.522,8,16,.500,19,22,.864,113,34,76,.447,31,62,.500,3,14,.214,24,30,.800,95
24,2013-03-16,CLE,@,SAS,L 113-119,240,43,85,.506,36,70,.514,7,15,.467,20,31,.645,113,45,78,.577,39,61,.639,6,17,.353,23,29,.793,119
25,2013-03-20,BRK,@,DAL,W 113-96,240,45,89,.506,38,68,.559,7,21,.333,16,21,.762,113,40,80,.500,33,61,.541,7,19,.368,9,15,.600,96
26,2013-04-03,BRK,@,CLE,W 113-95,240,43,76,.566,33,55,.600,10,21,.476,17,22,.773,113,34,89,.382,30,75,.400,4,14,.286,23,26,.885,95
27,2013-04-03,DEN,@,UTA,W 113-96,240,41,73,.562,34,55,.618,7,18,.389,24,32,.750,113,39,84,.464,33,64,.516,6,20,.300,12,18,.667,96
28,2013-04-10,LAL,@,POR,W 113-106,240,43,73,.589,37,54,.685,6,19,.316,21,24,.875,113,38,85,.447,26,59,.441,12,26,.462,18,20,.900,106
29,2013-04-16,TOR,@,ATL,W 113-96,240,40,78,.513,30,51,.588,10,27,.370,23,27,.852,113,35,88,.398,26,60,.433,9,28,.321,17,23,.739,96
30,2012-11-10,SAS,@,POR,W 112-109,240,40,70,.571,33,52,.635,7,18,.389,25,31,.806,112,42,89,.472,32,67,.478,10,22,.455,15,19,.789,109
31,2012-11-14,CHI,@,PHO,W 112-106,265,44,88,.500,38,76,.500,6,12,.500,18,25,.720,112,42,105,.400,36,84,.429,6,21,.286,16,17,.941,106
32,2012-11-16,ATL,@,SAC,W 112-96,240,42,76,.553,34,61,.557,8,15,.533,20,27,.741,112,39,85,.459,31,65,.477,8,20,.400,10,14,.714,96
33,2012-11-21,SAS,@,BOS,W 112-100,240,45,77,.584,37,61,.607,8,16,.500,14,19,.737,112,41,77,.532,38,69,.551,3,8,.375,15,17,.882,100
34,2012-12-06,NYK,@,MIA,W 112-92,240,41,91,.451,23,47,.489,18,44,.409,12,19,.632,112,32,76,.421,26,60,.433,6,16,.375,22,28,.786,92
35,2012-12-31,MIA,@,ORL,W 112-110,265,40,85,.471,34,64,.531,6,21,.286,26,35,.743,112,42,88,.477,34,65,.523,8,23,.348,18,22,.818,110
36,2013-01-05,HOU,@,CLE,W 112-104,240,37,79,.468,25,45,.556,12,34,.353,26,36,.722,112,36,91,.396,29,68,.426,7,23,.304,25,28,.893,104
37,2013-01-06,DEN,@,LAL,W 112-105,240,44,101,.436,35,77,.455,9,24,.375,15,23,.652,112,38,82,.463,28,52,.538,10,30,.333,19,27,.704,105
38,2013-01-08,LAL,@,HOU,L 112-125,240,43,91,.473,29,60,.483,14,31,.452,12,13,.923,112,48,87,.552,37,62,.597,11,25,.440,18,23,.783,125
39,2013-01-09,UTA,@,CHA,W 112-102,240,44,82,.537,34,60,.567,10,22,.455,14,21,.667,112,42,88,.477,38,80,.475,4,8,.500,14,22,.636,102
40,2013-01-18,WAS,@,DEN,W 112-108,240,41,80,.513,30,57,.526,11,23,.478,19,28,.679,112,41,84,.488,34,68,.500,7,16,.438,19,31,.613,108
41,2013-03-08,PHO,@,SAC,L 112-121,240,43,90,.478,36,67,.537,7,23,.304,19,23,.826,112,45,82,.549,32,55,.582,13,27,.481,18,21,.857,121
1,2013-03-30,IND,@,PHO,W 112-104,240,37,80,.463,33,65,.508,4,15,.267,34,46,.739,112,40,82,.488,34,70,.486,6,12,.500,18,19,.947,104
2,2013-04-03,HOU,@,SAC,W 112-102,240,42,86,.488,32,56,.571,10,30,.333,18,21,.857,112,34,87,.391,28,66,.424,6,21,.286,28,34,.824,102
3,2013-04-15,DEN,@,MIL,W 112-111,240,37,85,.435,31,71,.437,6,14,.429,32,46,.696,112,42,100,.420,30,65,.462,12,35,.343,15,23,.652,111
4,2013-04-15,HOU,@,PHO,L 112-119,240,43,92,.467,32,63,.508,11,29,.379,15,23,.652,112,47,95,.495,40,72,.556,7,23,.304,18,23,.783,119
5,2013-04-17,LAC,@,SAC,W 112-108,240,44,88,.500,32,64,.500,12,24,.500,12,18,.667,112,40,89,.449,31,63,.492,9,26,.346,19,25,.760,108
6,2012-11-21,NYK,@,DAL,L 111-114,240,39,77,.506,24,46,.522,15,31,.484,18,22,.818,111,42,85,.494,29,56,.518,13,29,.448,17,21,.810,114
7,2012-11-21,LAC,@,OKC,L 111-117,265,40,93,.430,33,73,.452,7,20,.350,24,33,.727,111,36,79,.456,25,56,.446,11,23,.478,34,39,.872,117
8,2012-11-25,SAS,@,TOR,W 111-106,290,44,103,.427,36,76,.474,8,27,.296,15,19,.789,111,40,110,.364,34,86,.395,6,24,.250,20,24,.833,106
9,2012-12-15,LAC,@,MIL,W 111-85,240,44,82,.537,39,71,.549,5,11,.455,18,24,.750,111,30,83,.361,23,62,.371,7,21,.333,18,25,.720,85
10,2012-12-16,LAL,@,PHI,W 111-98,240,39,80,.488,25,46,.543,14,34,.412,19,24,.792,111,41,83,.494,31,58,.534,10,25,.400,6,11,.545,98
11,2012-12-30,SAS,@,DAL,W 111-86,240,41,81,.506,33,62,.532,8,19,.421,21,24,.875,111,38,95,.400,37,79,.468,1,16,.063,9,10,.900,86
12,2013-01-15,POR,@,DEN,L 111-115,265,42,88,.477,34,61,.557,8,27,.296,19,23,.826,111,47,99,.475,38,74,.514,9,25,.360,12,19,.632,115
13,2013-01-15,NOH,@,PHI,W 111-99,240,44,83,.530,34,65,.523,10,18,.556,13,18,.722,111,39,82,.476,28,61,.459,11,21,.524,10,13,.769,99
14,2013-01-20,DAL,@,ORL,W 111-105,240,45,90,.500,37,75,.493,8,15,.533,13,15,.867,111,40,79,.506,31,58,.534,9,21,.429,16,20,.800,105
15,2013-01-25,BOS,@,ATL,L 111-123,290,42,93,.452,35,74,.473,7,19,.368,20,20,1.000,111,42,94,.447,30,58,.517,12,36,.333,27,36,.750,123
16,2013-02-01,LAL,@,MIN,W 111-100,240,39,92,.424,27,60,.450,12,32,.375,21,25,.840,111,41,89,.461,31,67,.463,10,22,.455,8,18,.444,100
17,2013-02-08,NOH,@,ATL,W 111-100,240,45,86,.523,36,70,.514,9,16,.563,12,18,.667,111,35,74,.473,22,50,.440,13,24,.542,17,23,.739,100
18,2013-02-09,DEN,@,CLE,W 111-103,240,40,80,.500,34,63,.540,6,17,.353,25,34,.735,111,37,84,.440,28,64,.438,9,20,.450,20,26,.769,103
19,2013-02-10,SAS,@,BRK,W 111-86,240,43,73,.589,31,54,.574,12,19,.632,13,20,.650,111,34,72,.472,28,53,.528,6,19,.316,12,17,.706,86
20,2013-02-10,HOU,@,SAC,L 111-117,240,44,89,.494,34,56,.607,10,33,.303,13,17,.765,111,40,87,.460,29,67,.433,11,20,.550,26,27,.963,117
21,2013-02-19,MIL,@,BRK,L 111-113,265,46,96,.479,39,76,.513,7,20,.350,12,18,.667,111,43,91,.473,33,72,.458,10,19,.526,17,23,.739,113
22,2013-02-22,MIN,@,OKC,L 111-127,240,41,85,.482,35,68,.515,6,17,.353,23,29,.793,111,48,83,.578,39,69,.565,9,14,.643,22,22,1.000,127
23,2013-02-27,DEN,@,POR,W 111-109,240,45,87,.517,42,73,.575,3,14,.214,18,31,.581,111,38,85,.447,28,60,.467,10,25,.400,23,27,.852,109
24,2013-03-18,IND,@,CLE,W 111-90,240,39,88,.443,31,66,.470,8,22,.364,25,29,.862,111,35,92,.380,29,68,.426,6,24,.250,14,21,.667,90
25,2013-03-27,BRK,@,POR,W 111-93,240,46,95,.484,41,75,.547,5,20,.250,14,25,.560,111,36,82,.439,28,64,.438,8,18,.444,13,21,.619,93
26,2013-04-05,GSW,@,PHO,W 111-107,240,44,86,.512,35,70,.500,9,16,.563,14,16,.875,111,44,72,.611,39,58,.672,5,14,.357,14,17,.824,107
27,2013-04-10,DET,@,CLE,W 111-104,240,40,80,.500,36,64,.563,4,16,.250,27,42,.643,111,40,82,.488,37,67,.552,3,15,.200,21,26,.808,104
28,2013-04-11,NYK,@,CHI,L 111-118,265,42,104,.404,32,74,.432,10,30,.333,17,22,.773,111,39,87,.448,29,60,.483,10,27,.370,30,37,.811,118
29,2012-11-05,NYK,@,PHI,W 110-88,240,39,84,.464,26,52,.500,13,32,.406,19,19,1.000,110,29,86,.337,21,64,.328,8,22,.364,22,26,.846,88
30,2012-11-16,ORL,@,DET,W 110-106,240,44,89,.494,37,72,.514,7,17,.412,15,17,.882,110,44,82,.537,42,74,.568,2,8,.250,16,20,.800,106
31,2012-11-16,OKC,@,NOH,W 110-95,240,40,74,.541,26,45,.578,14,29,.483,16,20,.800,110,33,78,.423,26,66,.394,7,12,.583,22,28,.786,95
32,2012-11-28,SAS,@,ORL,W 110-89,240,44,84,.524,33,59,.559,11,25,.440,11,15,.733,110,41,95,.432,39,80,.488,2,15,.133,5,8,.625,89
33,2012-12-03,TOR,@,DEN,L 110-113,240,42,86,.488,33,58,.569,9,28,.321,17,19,.895,110,40,85,.471,34,70,.486,6,15,.400,27,43,.628,113
34,2012-12-20,MIA,@,DAL,W 110-95,240,42,78,.538,32,50,.640,10,28,.357,16,18,.889,110,37,96,.385,34,74,.459,3,22,.136,18,21,.857,95
35,2012-12-21,CHI,@,NYK,W 110-106,240,37,83,.446,29,65,.446,8,18,.444,28,33,.848,110,38,91,.418,30,65,.462,8,26,.308,22,25,.880,106
36,2013-01-02,BRK,@,OKC,W 110-93,240,38,76,.500,29,59,.492,9,17,.529,25,29,.862,110,36,73,.493,28,54,.519,8,19,.421,13,17,.765,93
37,2013-01-19,MIL,@,POR,W 110-104,240,39,88,.443,33,70,.471,6,18,.333,26,32,.813,110,34,81,.420,26,53,.491,8,28,.286,28,32,.875,104
38,2013-01-26,IND,@,UTA,L 110-114,265,44,82,.537,37,61,.607,7,21,.333,15,18,.833,110,44,83,.530,41,73,.562,3,10,.300,23,26,.885,114
39,2013-01-30,HOU,@,DEN,L 110-118,240,39,81,.481,31,54,.574,8,27,.296,24,35,.686,110,42,82,.512,34,54,.630,8,28,.286,26,36,.722,118
40,2013-02-02,OKC,@,CLE,L 110-115,240,41,83,.494,34,62,.548,7,21,.333,21,26,.808,110,43,90,.478,34,72,.472,9,18,.500,20,23,.870,115
41,2013-02-14,MIA,@,OKC,W 110-100,240,41,88,.466,30,59,.508,11,29,.379,17,22,.773,110,32,73,.438,29,60,.483,3,13,.231,33,34,.971,100
42,2013-02-25,BOS,@,UTA,W 110-107,265,41,86,.477,31,59,.525,10,27,.370,18,20,.900,110,39,88,.443,31,71,.437,8,17,.471,21,24,.875,107
43,2013-02-27,MIL,@,HOU,W 110-107,240,43,89,.483,34,65,.523,9,24,.375,15,20,.750,110,42,89,.472,35,66,.530,7,23,.304,16,25,.640,107
44,2013-04-10,NOH,@,SAC,L 110-121,240,38,78,.487,32,60,.533,6,18,.333,28,35,.800,110,47,85,.553,37,65,.569,10,20,.500,17,23,.739,121
45,2012-11-02,HOU,@,ATL,W 109-102,240,38,90,.422,30,60,.500,8,30,.267,25,29,.862,109,40,85,.471,33,63,.524,7,22,.318,15,17,.882,102
46,2012-11-18,GSW,@,OKC,L 109-119,240,43,82,.524,38,66,.576,5,16,.313,18,22,.818,109,42,83,.506,29,63,.460,13,20,.650,22,26,.846,119
47,2012-12-07,GSW,@,BRK,W 109-102,240,46,90,.511,37,71,.521,9,19,.474,8,10,.800,109,37,87,.425,26,54,.481,11,33,.333,17,23,.739,102
48,2012-12-17,HOU,@,NYK,W 109-96,240,40,78,.513,30,49,.612,10,29,.345,19,24,.792,109,39,90,.433,30,59,.508,9,31,.290,9,16,.563,96
49,2013-01-02,DAL,@,MIA,L 109-119,265,41,94,.436,31,66,.470,10,28,.357,17,20,.850,109,42,89,.472,32,63,.508,10,26,.385,25,31,.806,119
1,2013-01-08,BRK,@,PHI,W 109-89,240,40,83,.482,30,59,.508,10,24,.417,19,22,.864,109,38,79,.481,31,62,.500,7,17,.412,6,10,.600,89
2,2013-01-22,OKC,@,LAC,W 109-97,240,41,78,.526,26,51,.510,15,27,.556,12,14,.857,109,39,84,.464,35,68,.515,4,16,.250,15,21,.714,97
3,2013-02-01,DAL,@,PHO,W 109-99,240,40,88,.455,32,67,.478,8,21,.381,21,25,.840,109,38,89,.427,34,74,.459,4,15,.267,19,25,.760,99
4,2013-02-05,GSW,@,HOU,L 109-140,240,41,86,.477,38,71,.535,3,15,.200,24,30,.800,109,46,91,.505,23,51,.451,23,40,.575,25,35,.714,140
5,2013-02-08,SAS,@,DET,L 109-119,240,37,81,.457,27,57,.474,10,24,.417,25,30,.833,109,46,89,.517,36,67,.537,10,22,.455,17,20,.850,119
6,2013-02-09,UTA,@,SAC,L 109-120,240,40,82,.488,36,67,.537,4,15,.267,25,26,.962,109,44,85,.518,36,66,.545,8,19,.421,24,35,.686,120
7,2013-03-05,BOS,@,PHI,W 109-101,240,42,83,.506,31,64,.484,11,19,.579,14,16,.875,109,41,100,.410,36,79,.456,5,21,.238,14,18,.778,101
8,2013-03-17,ORL,@,MIL,L 109-115,240,47,93,.505,42,72,.583,5,21,.238,10,15,.667,109,40,90,.444,28,63,.444,12,27,.444,23,26,.885,115
9,2013-03-30,OKC,@,MIL,W 109-99,240,40,75,.533,36,59,.610,4,16,.250,25,32,.781,109,37,98,.378,25,69,.362,12,29,.414,13,15,.867,99
10,2013-04-01,IND,@,LAC,W 109-106,240,39,71,.549,29,48,.604,10,23,.435,21,28,.750,109,39,80,.488,34,64,.531,5,16,.313,23,26,.885,106
11,2013-04-14,POR,@,DEN,L 109-118,240,38,82,.463,26,50,.520,12,32,.375,21,26,.808,109,43,81,.531,35,59,.593,8,22,.364,24,27,.889,118
12,2012-11-05,CLE,@,LAC,W 108-101,240,40,92,.435,26,63,.413,14,29,.483,14,22,.636,108,39,74,.527,30,49,.612,9,25,.360,14,16,.875,101
13,2012-11-07,MEM,@,MIL,W 108-90,240,44,83,.530,38,67,.567,6,16,.375,14,19,.737,108,35,91,.385,29,76,.382,6,15,.400,14,21,.667,90
14,2012-11-18,HOU,@,LAL,L 108-119,240,44,90,.489,35,67,.522,9,23,.391,11,18,.611,108,46,85,.541,37,65,.569,9,20,.450,18,28,.643,119
15,2012-11-23,NOH,@,PHO,L 108-111,265,40,78,.513,27,52,.519,13,26,.500,15,18,.833,108,44,90,.489,33,65,.508,11,25,.440,12,19,.632,111
16,2012-11-24,CLE,@,MIA,L 108-110,240,35,79,.443,21,48,.438,14,31,.452,24,33,.727,108,36,69,.522,27,50,.540,9,19,.474,29,37,.784,110
17,2012-11-24,CHA,@,WAS,W 108-106,290,34,83,.410,22,55,.400,12,28,.429,28,36,.778,108,34,93,.366,28,66,.424,6,27,.222,32,39,.821,106
18,2012-12-07,CHI,@,DET,W 108-104,240,43,82,.524,38,68,.559,5,14,.357,17,21,.810,108,36,70,.514,28,56,.500,8,14,.571,24,31,.774,104
19,2012-12-07,LAL,@,OKC,L 108-114,240,36,84,.429,25,56,.446,11,28,.393,25,31,.806,108,41,84,.488,32,67,.478,9,17,.529,23,28,.821,114
20,2013-01-06,CHA,@,DET,W 108-101,265,40,92,.435,37,79,.468,3,13,.231,25,29,.862,108,40,80,.500,32,54,.593,8,26,.308,13,19,.684,101
21,2013-01-11,CHI,@,NYK,W 108-101,240,39,68,.574,34,57,.596,5,11,.455,25,34,.735,108,37,90,.411,26,68,.382,11,22,.500,16,23,.696,101
22,2013-01-25,MIL,@,CLE,L 108-113,240,43,92,.467,29,64,.453,14,28,.500,8,13,.615,108,45,86,.523,39,71,.549,6,15,.400,17,22,.773,113
23,2013-01-29,GSW,@,CLE,W 108-95,240,45,84,.536,34,68,.500,11,16,.688,7,10,.700,108,36,84,.429,32,66,.485,4,18,.222,19,25,.760,95
24,2013-02-06,HOU,@,MIA,L 108-114,240,39,80,.488,30,55,.545,9,25,.360,21,25,.840,108,40,82,.488,30,59,.508,10,23,.435,24,28,.857,114
25,2013-02-08,ORL,@,CLE,L 108-119,240,45,86,.523,37,65,.569,8,21,.381,10,13,.769,108,39,80,.488,32,66,.485,7,14,.500,34,41,.829,119
26,2013-02-12,DEN,@,TOR,L 108-109,240,44,85,.518,38,69,.551,6,16,.375,14,20,.700,108,39,83,.470,29,62,.468,10,21,.476,21,23,.913,109
27,2013-02-13,DEN,@,BRK,L 108-119,240,42,79,.532,30,62,.484,12,17,.706,12,22,.545,108,41,75,.547,25,48,.521,16,27,.593,21,30,.700,119
28,2013-02-13,ATL,@,ORL,W 108-76,240,41,92,.446,31,58,.534,10,34,.294,16,23,.696,108,34,82,.415,31,68,.456,3,14,.214,5,9,.556,76
29,2013-02-19,SAS,@,SAC,W 108-102,240,35,75,.467,25,45,.556,10,30,.333,28,35,.800,108,34,90,.378,25,65,.385,9,25,.360,25,29,.862,102
30,2013-02-22,SAC,@,ATL,L 108-122,240,38,88,.432,26,66,.394,12,22,.545,20,25,.800,108,49,92,.533,37,65,.569,12,27,.444,12,19,.632,122
31,2013-02-25,LAL,@,DEN,L 108-119,240,43,78,.551,35,59,.593,8,19,.421,14,31,.452,108,49,88,.557,44,70,.629,5,18,.278,16,27,.593,119
32,2013-03-03,OKC,@,LAC,W 108-104,240,38,80,.475,31,59,.525,7,21,.333,25,34,.735,108,38,82,.463,29,58,.500,9,24,.375,19,22,.864,104
33,2013-03-03,MEM,@,ORL,W 108-82,240,44,83,.530,33,59,.559,11,24,.458,9,15,.600,108,29,73,.397,27,58,.466,2,15,.133,22,26,.846,82
34,2013-03-04,UTA,@,MIL,L 108-109,265,40,99,.404,36,86,.419,4,13,.308,24,31,.774,108,45,95,.474,35,71,.493,10,24,.417,9,13,.692,109
35,2013-03-06,HOU,@,DAL,L 108-112,240,35,78,.449,23,46,.500,12,32,.375,26,33,.788,108,45,83,.542,34,57,.596,11,26,.423,11,14,.786,112
36,2013-03-06,LAL,@,NOH,W 108-102,240,38,78,.487,27,50,.540,11,28,.393,21,29,.724,108,38,88,.432,29,64,.453,9,24,.375,17,20,.850,102
37,2013-03-11,DEN,@,PHO,W 108-93,240,44,86,.512,41,74,.554,3,12,.250,17,25,.680,108,35,84,.417,29,64,.453,6,20,.300,17,22,.773,93
38,2013-03-17,GSW,@,HOU,W 108-78,240,44,96,.458,31,70,.443,13,26,.500,7,9,.778,108,28,86,.326,19,51,.373,9,35,.257,13,16,.813,78
39,2013-03-17,MIA,@,TOR,W 108-91,240,39,67,.582,29,45,.644,10,22,.455,20,29,.690,108,39,94,.415,37,74,.500,2,20,.100,11,12,.917,91
40,2013-03-24,UTA,@,DAL,L 108-113,240,42,82,.512,35,65,.538,7,17,.412,17,21,.810,108,38,70,.543,29,52,.558,9,18,.500,28,33,.848,113
41,2013-03-25,MIA,@,ORL,W 108-94,240,37,78,.474,22,50,.440,15,28,.536,19,29,.655,108,37,86,.430,28,62,.452,9,24,.375,11,18,.611,94
42,2013-03-27,ORL,@,CHA,L 108-114,240,44,84,.524,37,65,.569,7,19,.368,13,18,.722,108,44,85,.518,38,65,.585,6,20,.300,20,28,.714,114
43,2013-03-29,MIA,@,NOH,W 108-89,240,42,69,.609,28,42,.667,14,27,.519,10,16,.625,108,34,74,.459,29,56,.518,5,18,.278,16,18,.889,89
44,2013-04-01,DET,@,TOR,W 108-98,240,43,77,.558,36,62,.581,7,15,.467,15,21,.714,108,41,81,.506,33,60,.550,8,21,.381,8,10,.800,98
1,2013-04-17,MIN,@,SAS,W 108-95,240,42,91,.462,30,62,.484,12,29,.414,12,16,.750,108,33,79,.418,26,61,.426,7,18,.389,22,22,1.000,95
2,2012-10-30,BOS,@,MIA,L 107-120,240,39,75,.520,33,62,.532,6,13,.462,23,28,.821,107,43,79,.544,35,63,.556,8,16,.500,26,32,.813,120
3,2012-11-05,MIN,@,BRK,W 107-96,240,44,88,.500,37,68,.544,7,20,.350,12,15,.800,107,35,73,.479,22,50,.440,13,23,.565,13,18,.722,96
4,2012-11-09,BRK,@,ORL,W 107-68,240,41,82,.500,32,59,.542,9,23,.391,16,25,.640,107,30,70,.429,26,59,.441,4,11,.364,4,8,.500,68
5,2012-11-10,DEN,@,GSW,W 107-101,290,43,113,.381,38,89,.427,5,24,.208,16,27,.593,107,39,102,.382,30,77,.390,9,25,.360,14,23,.609,101
6,2012-11-14,MEM,@,OKC,W 107-97,240,44,93,.473,37,76,.487,7,17,.412,12,14,.857,107,35,72,.486,29,59,.492,6,13,.462,21,26,.808,97
7,2012-11-21,NOH,@,IND,L 107-115,265,39,92,.424,33,82,.402,6,10,.600,23,27,.852,107,40,92,.435,25,65,.385,15,27,.556,20,28,.714,115
8,2012-12-13,LAL,@,NYK,L 107-116,240,35,84,.417,23,47,.489,12,37,.324,25,29,.862,107,42,79,.532,30,54,.556,12,25,.480,20,30,.667,116
9,2012-12-15,ORL,@,CHA,W 107-98,240,43,79,.544,38,62,.613,5,17,.294,16,19,.842,107,36,78,.462,32,66,.485,4,12,.333,22,29,.759,98
10,2012-12-29,PHO,@,MIN,L 107-111,240,45,97,.464,43,80,.538,2,17,.118,15,24,.625,107,45,89,.506,40,71,.563,5,18,.278,16,26,.615,111
11,2013-01-13,MIL,@,TOR,W 107-96,240,40,77,.519,32,58,.552,8,19,.421,19,23,.826,107,36,85,.424,33,72,.458,3,13,.231,21,27,.778,96
12,2013-01-16,CHI,@,TOR,W 107-105,265,39,86,.453,36,75,.480,3,11,.273,26,36,.722,107,38,85,.447,32,69,.464,6,16,.375,23,32,.719,105
13,2013-02-11,LAC,@,PHI,W 107-90,240,44,75,.587,36,56,.643,8,19,.421,11,22,.500,107,35,84,.417,26,66,.394,9,18,.500,11,16,.688,90
14,2013-02-22,POR,@,LAL,L 107-111,240,46,94,.489,38,74,.514,8,20,.400,7,12,.583,107,40,85,.471,34,67,.507,6,18,.333,25,34,.735,111
15,2013-03-15,MIA,@,MIL,W 107-94,240,41,79,.519,34,64,.531,7,15,.467,18,22,.818,107,33,89,.371,24,64,.375,9,25,.360,19,21,.905,94
16,2013-03-17,OKC,@,DAL,W 107-101,240,39,80,.488,34,59,.576,5,21,.238,24,30,.800,107,38,83,.458,29,62,.468,9,21,.429,16,16,1.000,101
17,2013-03-27,ATL,@,TOR,W 107-88,240,40,81,.494,30,60,.500,10,21,.476,17,20,.850,107,35,78,.449,31,61,.508,4,17,.235,14,20,.700,88
18,2013-03-29,ATL,@,BOS,L 107-118,240,40,88,.455,32,68,.471,8,20,.400,19,24,.792,107,45,83,.542,34,60,.567,11,23,.478,17,21,.810,118
19,2013-03-30,BRK,@,UTA,L 107-116,240,42,81,.519,34,58,.586,8,23,.348,15,19,.789,107,45,81,.556,35,64,.547,10,17,.588,16,24,.667,116
20,2013-04-03,MIN,@,MIL,W 107-98,240,44,84,.524,36,71,.507,8,13,.615,11,16,.688,107,42,96,.438,34,73,.466,8,23,.348,6,9,.667,98
21,2013-04-14,DAL,@,NOH,W 107-89,240,45,86,.523,36,65,.554,9,21,.429,8,8,1.000,107,33,87,.379,24,65,.369,9,22,.409,14,18,.778,89
22,2012-10-31,LAL,@,POR,L 106-116,240,36,72,.500,28,54,.519,8,18,.444,26,32,.813,106,42,83,.506,33,63,.524,9,20,.450,23,28,.821,116
23,2012-11-09,PHI,@,BOS,W 106-100,240,40,82,.488,33,69,.478,7,13,.538,19,23,.826,106,37,76,.487,33,66,.500,4,10,.400,22,31,.710,100
24,2012-11-16,GSW,@,MIN,W 106-98,240,43,85,.506,41,70,.586,2,15,.133,18,26,.692,106,34,79,.430,27,61,.443,7,18,.389,23,29,.793,98
25,2012-11-21,MIL,@,MIA,L 106-113,265,46,109,.422,41,80,.513,5,29,.172,9,12,.750,106,41,86,.477,33,68,.485,8,18,.444,23,33,.697,113
26,2012-12-09,DEN,@,NYK,L 106-112,240,40,72,.556,35,55,.636,5,17,.294,21,29,.724,106,37,86,.430,25,56,.446,12,30,.400,26,37,.703,112
27,2012-12-15,DAL,@,MIN,L 106-114,265,39,84,.464,32,70,.457,7,14,.500,21,25,.840,106,41,94,.436,35,71,.493,6,23,.261,26,32,.813,114
28,2012-12-18,SAS,@,DEN,L 106-112,240,38,95,.400,24,59,.407,14,36,.389,16,18,.889,106,38,87,.437,31,68,.456,7,19,.368,29,42,.690,112
29,2012-12-28,DEN,@,DAL,W 106-85,240,43,94,.457,31,66,.470,12,28,.429,8,14,.571,106,33,88,.375,28,63,.444,5,25,.200,14,21,.667,85
30,2013-01-04,CLE,@,CHA,W 106-104,240,39,78,.500,32,62,.516,7,16,.438,21,29,.724,106,37,82,.451,29,65,.446,8,17,.471,22,28,.786,104
31,2013-01-15,TOR,@,BRK,L 106-113,240,40,82,.488,33,69,.478,7,13,.538,19,23,.826,106,40,81,.494,32,60,.533,8,21,.381,25,28,.893,113
32,2013-01-18,CHA,@,ORL,W 106-100,240,37,79,.468,33,67,.493,4,12,.333,28,38,.737,106,37,79,.468,26,48,.542,11,31,.355,15,21,.714,100
33,2013-01-23,PHO,@,SAC,W 106-96,240,43,90,.478,37,71,.521,6,19,.316,14,16,.875,106,38,79,.481,33,68,.485,5,11,.455,15,24,.625,96
34,2013-01-26,BRK,@,HOU,L 106-119,240,36,80,.450,20,44,.455,16,36,.444,18,21,.857,106,43,87,.494,31,59,.525,12,28,.429,21,27,.778,119
35,2013-01-29,NOH,@,LAL,L 106-111,240,39,92,.424,30,73,.411,9,19,.474,19,21,.905,106,39,79,.494,27,46,.587,12,33,.364,21,33,.636,111
1,2013-02-22,HOU,@,BRK,W 106-96,240,41,77,.532,25,47,.532,16,30,.533,8,12,.667,106,40,91,.440,30,61,.492,10,30,.333,6,11,.545,96
2,2013-03-12,LAL,@,ORL,W 106-97,240,34,73,.466,25,48,.521,9,25,.360,29,47,.617,106,37,93,.398,27,61,.443,10,32,.313,13,17,.765,97
3,2013-03-23,BOS,@,MEM,L 106-110,240,38,74,.514,29,54,.537,9,20,.450,21,28,.750,106,43,94,.457,39,83,.470,4,11,.364,20,24,.833,110
4,2013-04-12,OKC,@,POR,W 106-90,240,40,77,.519,31,55,.564,9,22,.409,17,21,.810,106,36,88,.409,30,68,.441,6,20,.300,12,18,.667,90
5,2013-04-15,SAS,@,GSW,L 106-116,240,45,98,.459,37,74,.500,8,24,.333,8,13,.615,106,46,85,.541,37,65,.569,9,20,.450,15,18,.833,116
6,2012-10-31,HOU,@,DET,W 105-96,240,39,79,.494,29,52,.558,10,27,.370,17,23,.739,105,35,79,.443,29,63,.460,6,16,.375,20,26,.769,96
7,2012-11-02,LAC,@,LAL,W 105-95,240,38,84,.452,30,62,.484,8,22,.364,21,27,.778,105,34,68,.500,27,52,.519,7,16,.438,20,28,.714,95
8,2012-11-09,CLE,@,PHO,L 105-107,240,37,77,.481,28,56,.500,9,21,.429,22,27,.815,105,38,81,.469,32,64,.500,6,17,.353,25,33,.758,107
9,2012-11-12,MIL,@,PHI,W 105-96,240,41,80,.513,34,60,.567,7,20,.350,16,18,.889,105,37,85,.435,27,61,.443,10,24,.417,12,16,.750,96
10,2012-11-19,GSW,@,DAL,W 105-101,265,37,91,.407,28,67,.418,9,24,.375,22,30,.733,105,37,86,.430,27,65,.415,10,21,.476,17,24,.708,101
11,2012-11-26,NOH,@,LAC,W 105-98,240,36,71,.507,21,46,.457,15,25,.600,18,23,.783,105,37,79,.468,19,42,.452,18,37,.486,6,11,.545,98
12,2012-11-29,DEN,@,GSW,L 105-106,240,38,84,.452,28,63,.444,10,21,.476,19,24,.792,105,44,86,.512,36,68,.529,8,18,.444,10,13,.769,106
13,2012-12-03,LAC,@,UTA,W 105-104,240,42,89,.472,38,68,.559,4,21,.190,17,24,.708,105,42,74,.568,33,54,.611,9,20,.450,11,15,.733,104
14,2012-12-04,LAL,@,HOU,L 105-107,240,38,83,.458,31,62,.500,7,21,.333,22,34,.647,105,38,101,.376,31,67,.463,7,34,.206,24,31,.774,107
15,2012-12-04,MIN,@,PHI,W 105-88,240,41,77,.532,28,52,.538,13,25,.520,10,17,.588,105,35,83,.422,30,63,.476,5,20,.250,13,23,.565,88
16,2012-12-12,DEN,@,MIN,L 105-108,240,42,83,.506,35,67,.522,7,16,.438,14,24,.583,105,38,87,.437,36,73,.493,2,14,.143,30,37,.811,108
17,2012-12-14,DET,@,BRK,L 105-107,290,40,99,.404,35,83,.422,5,16,.313,20,26,.769,105,42,93,.452,32,67,.478,10,26,.385,13,16,.813,107
18,2012-12-26,MIA,@,CHA,W 105-92,240,37,81,.457,25,58,.431,12,23,.522,19,25,.760,105,34,78,.436,29,64,.453,5,14,.357,19,28,.679,92
19,2012-12-27,DAL,@,OKC,L 105-111,265,40,95,.421,29,71,.408,11,24,.458,14,16,.875,105,39,93,.419,29,68,.426,10,25,.400,23,28,.821,111
20,2012-12-28,NYK,@,SAC,L 105-106,240,41,83,.494,30,53,.566,11,30,.367,12,20,.600,105,39,86,.453,24,56,.429,15,30,.500,13,17,.765,106
21,2013-01-01,POR,@,NYK,W 105-100,240,41,81,.506,30,48,.625,11,33,.333,12,18,.667,105,36,84,.429,26,47,.553,10,37,.270,18,24,.750,100
22,2013-01-04,SAC,@,TOR,W 105-96,240,40,76,.526,36,64,.563,4,12,.333,21,30,.700,105,30,79,.380,19,46,.413,11,33,.333,25,37,.676,96
23,2013-01-09,ORL,@,DEN,L 105-108,240,44,93,.473,36,69,.522,8,24,.333,9,10,.900,105,41,94,.436,37,82,.451,4,12,.333,22,36,.611,108
24,2013-01-09,LAL,@,SAS,L 105-108,240,44,95,.463,36,68,.529,8,27,.296,9,15,.600,105,41,84,.488,29,59,.492,12,25,.480,14,16,.875,108
25,2013-01-13,GSW,@,DEN,L 105-116,240,43,83,.518,30,59,.508,13,24,.542,6,8,.750,105,43,90,.478,34,63,.540,9,27,.333,21,27,.778,116
26,2013-01-21,SAC,@,NOH,L 105-114,240,38,81,.469,35,66,.530,3,15,.200,26,32,.813,105,43,89,.483,31,64,.484,12,25,.480,16,21,.762,114
27,2013-01-23,DEN,@,HOU,W 105-95,240,40,86,.465,32,65,.492,8,21,.381,17,25,.680,105,37,83,.446,26,49,.531,11,34,.324,10,13,.769,95
28,2013-01-25,OKC,@,SAC,W 105-95,240,37,76,.487,31,53,.585,6,23,.261,25,30,.833,105,36,86,.419,28,71,.394,8,15,.533,15,21,.714,95
29,2013-01-30,MIA,@,BRK,W 105-85,240,43,83,.518,32,64,.500,11,19,.579,8,14,.571,105,31,69,.449,26,52,.500,5,17,.294,18,24,.750,85
30,2013-02-09,DET,@,MIL,W 105-100,240,41,83,.494,33,66,.500,8,17,.471,15,19,.789,105,34,86,.395,27,69,.391,7,17,.412,25,28,.893,100
31,2013-02-11,ATL,@,DAL,W 105-101,240,40,77,.519,31,51,.608,9,26,.346,16,23,.696,105,38,89,.427,29,68,.426,9,21,.429,16,20,.800,101
32,2013-02-11,NOH,@,DET,W 105-86,240,41,83,.494,31,62,.500,10,21,.476,13,14,.929,105,29,81,.358,24,62,.387,5,19,.263,23,33,.697,86
33,2013-02-19,MEM,@,DET,W 105-91,240,45,80,.563,42,71,.592,3,9,.333,12,20,.600,105,38,82,.463,29,62,.468,9,20,.450,6,10,.600,91
34,2013-02-19,CHA,@,ORL,W 105-92,240,38,81,.469,29,57,.509,9,24,.375,20,27,.741,105,37,89,.416,33,64,.516,4,25,.160,14,17,.824,92
35,2013-02-20,DET,@,CHA,W 105-99,240,40,81,.494,32,64,.500,8,17,.471,17,23,.739,105,36,89,.404,25,64,.391,11,25,.440,16,21,.762,99
36,2013-02-22,CHI,@,CHA,W 105-75,240,42,83,.506,37,69,.536,5,14,.357,16,20,.800,105,25,75,.333,21,59,.356,4,16,.250,21,35,.600,75
37,2013-02-24,CLE,@,MIA,L 105-109,240,39,78,.500,31,58,.534,8,20,.400,19,24,.792,105,39,75,.520,27,56,.482,12,19,.632,19,24,.792,109
38,2013-02-27,GSW,@,NYK,L 105-109,240,36,72,.500,21,45,.467,15,27,.556,18,21,.857,105,36,87,.414,25,53,.472,11,34,.324,26,33,.788,109
39,2013-02-27,PHO,@,SAS,W 105-101,265,44,95,.463,41,83,.494,3,12,.250,14,21,.667,105,35,81,.432,29,64,.453,6,17,.353,25,35,.714,101
40,2013-03-01,LAC,@,CLE,W 105-89,240,43,83,.518,36,58,.621,7,25,.280,12,20,.600,105,33,74,.446,28,58,.483,5,16,.313,18,28,.643,89
41,2013-03-04,ORL,@,NOH,W 105-102,240,43,87,.494,36,66,.545,7,21,.333,12,16,.750,105,37,80,.463,29,59,.492,8,21,.381,20,26,.769,102
42,2013-03-04,CHA,@,POR,L 105-122,240,45,97,.464,44,87,.506,1,10,.100,14,18,.778,105,49,82,.598,37,58,.638,12,24,.500,12,17,.706,122
43,2013-03-05,LAL,@,OKC,L 105-122,240,31,77,.403,19,48,.396,12,29,.414,31,40,.775,105,46,96,.479,38,73,.521,8,23,.348,22,24,.917,122
44,2013-03-09,HOU,@,PHO,L 105-107,240,37,86,.430,18,45,.400,19,41,.463,12,18,.667,105,37,82,.451,29,64,.453,8,18,.444,25,39,.641,107
45,2013-03-16,PHO,@,WAS,L 105-127,240,42,88,.477,36,67,.537,6,21,.286,15,20,.750,105,48,93,.516,34,72,.472,14,21,.667,17,20,.850,127
46,2013-03-17,ATL,@,BRK,W 105-93,240,44,84,.524,36,63,.571,8,21,.381,9,13,.692,105,36,86,.419,28,63,.444,8,23,.348,13,16,.813,93
47,2013-03-18,MIA,@,BOS,W 105-103,240,42,85,.494,35,65,.538,7,20,.350,14,21,.667,105,39,72,.542,29,51,.569,10,21,.476,15,24,.625,103
48,2013-03-26,MIN,@,DET,W 105-82,240,42,79,.532,28,53,.528,14,26,.538,7,8,.875,105,32,79,.405,25,59,.424,7,20,.350,11,13,.846,82
49,2013-03-27,SAC,@,GSW,W 105-98,240,41,90,.456,30,62,.484,11,28,.393,12,21,.571,105,41,90,.456,36,66,.545,5,24,.208,11,13,.846,98
50,2013-03-27,LAC,@,NOH,W 105-91,240,34,73,.466,21,44,.477,13,29,.448,24,28,.857,105,35,71,.493,31,57,.544,4,14,.286,17,24,.708,91
51,2013-03-29,UTA,@,POR,W 105-95,240,43,86,.500,39,67,.582,4,19,.211,15,18,.833,105,33,67,.493,27,54,.500,6,13,.462,23,32,.719,95
52,2013-04-12,DEN,@,DAL,L 105-108,265,41,93,.441,33,69,.478,8,24,.333,15,21,.714,105,43,95,.453,32,72,.444,11,23,.478,11,19,.579,108
53,2013-04-17,PHI,@,IND,W 105-95,240,43,85,.506,35,66,.530,8,19,.421,11,14,.786,105,36,80,.450,30,54,.556,6,26,.231,17,27,.630,95
54,2012-11-02,MEM,@,GSW,W 104-94,240,35,77,.455,29,64,.453,6,13,.462,28,34,.824,104,36,80,.450,26,60,.433,10,20,.500,12,17,.706,94
1,2012-11-04,ATL,@,OKC,W 104-95,240,41,83,.494,33,58,.569,8,25,.320,14,20,.700,104,33,71,.465,24,49,.490,9,22,.409,20,22,.909,95
2,2012-11-07,TOR,@,DAL,L 104-109,240,36,81,.444,31,59,.525,5,22,.227,27,31,.871,104,39,84,.464,31,63,.492,8,21,.381,23,35,.657,109
3,2012-11-15,NYK,@,SAS,W 104-100,240,39,86,.453,28,60,.467,11,26,.423,15,23,.652,104,38,87,.437,30,58,.517,8,29,.276,16,21,.762,100
4,2012-11-23,SAS,@,IND,W 104-97,240,41,83,.494,39,66,.591,2,17,.118,20,22,.909,104,38,92,.413,31,76,.408,7,16,.438,14,21,.667,97
5,2012-11-23,CLE,@,ORL,L 104-108,240,37,87,.425,29,61,.475,8,26,.308,22,30,.733,104,40,80,.500,29,59,.492,11,21,.524,17,20,.850,108
6,2012-11-30,PHI,@,CHA,W 104-98,240,44,86,.512,36,69,.522,8,17,.471,8,10,.800,104,39,83,.470,31,66,.470,8,17,.471,12,18,.667,98
7,2012-12-05,DEN,@,ATL,L 104-108,240,38,79,.481,31,62,.500,7,17,.412,21,25,.840,104,42,95,.442,34,73,.466,8,22,.364,16,19,.842,108
8,2012-12-05,GSW,@,DET,W 104-97,240,34,75,.453,25,51,.490,9,24,.375,27,34,.794,104,35,79,.443,29,58,.500,6,21,.286,21,31,.677,97
9,2012-12-08,DET,@,CLE,W 104-97,240,35,75,.467,26,60,.433,9,15,.600,25,33,.758,104,39,91,.429,33,64,.516,6,27,.222,13,17,.765,97
10,2012-12-10,GSW,@,CHA,W 104-96,240,38,84,.452,30,64,.469,8,20,.400,20,23,.870,104,31,83,.373,22,57,.386,9,26,.346,25,32,.781,96
11,2012-12-19,CHA,@,PHO,L 104-121,240,40,86,.465,34,76,.447,6,10,.600,18,22,.818,104,47,85,.553,30,57,.526,17,28,.607,10,11,.909,121
12,2012-12-28,TOR,@,NOH,W 104-97,265,37,85,.435,32,61,.525,5,24,.208,25,32,.781,104,37,82,.451,32,69,.464,5,13,.385,18,24,.750,97
13,2012-12-31,ATL,@,HOU,L 104-123,240,43,90,.478,31,67,.463,12,23,.522,6,7,.857,104,45,84,.536,29,55,.527,16,29,.552,17,22,.773,123
14,2013-01-06,OKC,@,TOR,W 104-92,240,38,77,.494,32,55,.582,6,22,.273,22,24,.917,104,34,76,.447,26,53,.491,8,23,.348,16,21,.762,92
15,2013-01-09,MIL,@,CHI,W 104-96,240,39,84,.464,29,62,.468,10,22,.455,16,21,.762,104,39,95,.411,35,85,.412,4,10,.400,14,20,.700,96
16,2013-01-12,ORL,@,LAC,W 104-101,240,39,81,.481,28,56,.500,11,25,.440,15,19,.789,104,43,88,.489,34,66,.515,9,22,.409,6,6,1.000,101
17,2013-01-23,ATL,@,CHA,W 104-92,240,43,87,.494,31,62,.500,12,25,.480,6,12,.500,104,31,76,.408,25,61,.410,6,15,.400,24,29,.828,92
18,2013-01-27,ATL,@,NYK,L 104-106,240,39,65,.600,29,42,.690,10,23,.435,16,20,.800,104,39,72,.542,23,45,.511,16,27,.593,12,17,.706,106
19,2013-01-27,DET,@,ORL,W 104-102,240,40,79,.506,29,56,.518,11,23,.478,13,18,.722,104,40,90,.444,30,67,.448,10,23,.435,12,16,.750,102
20,2013-01-29,DAL,@,POR,L 104-106,240,42,84,.500,34,69,.493,8,15,.533,12,15,.800,104,39,86,.453,29,58,.500,10,28,.357,18,23,.783,106
21,2013-01-30,CHI,@,MIL,W 104-88,240,45,91,.495,41,78,.526,4,13,.308,10,13,.769,104,34,82,.415,28,68,.412,6,14,.429,14,19,.737,88
22,2013-02-03,LAC,@,BOS,L 104-106,240,40,79,.506,31,58,.534,9,21,.429,15,21,.714,104,36,72,.500,25,54,.463,11,18,.611,23,27,.852,106
23,2013-02-05,MIL,@,DEN,L 104-112,240,48,100,.480,45,84,.536,3,16,.188,5,11,.455,104,40,91,.440,35,75,.467,5,16,.313,27,37,.730,112
24,2013-02-06,SAS,@,MIN,W 104-94,240,37,81,.457,27,56,.482,10,25,.400,20,21,.952,104,33,81,.407,25,63,.397,8,18,.444,20,23,.870,94
25,2013-02-10,POR,@,ORL,L 104-110,240,42,83,.506,32,56,.571,10,27,.370,10,12,.833,104,47,93,.505,42,78,.538,5,15,.333,11,18,.611,110
26,2013-02-12,POR,@,MIA,L 104-117,240,39,73,.534,31,49,.633,8,24,.333,18,20,.900,104,43,74,.581,35,55,.636,8,19,.421,23,27,.852,117
27,2013-02-22,DAL,@,NOH,W 104-100,240,40,84,.476,32,64,.500,8,20,.400,16,19,.842,104,37,91,.407,32,74,.432,5,17,.294,21,24,.875,100
28,2013-03-15,ORL,@,OKC,L 104-117,240,40,92,.435,33,65,.508,7,27,.259,17,21,.810,104,42,76,.553,38,63,.603,4,13,.308,29,43,.674,117
29,2013-03-22,POR,@,ATL,W 104-93,240,41,87,.471,31,69,.449,10,18,.556,12,16,.750,104,37,83,.446,30,59,.508,7,24,.292,12,16,.750,93
30,2013-03-24,ATL,@,MIL,W 104-99,240,39,78,.500,29,52,.558,10,26,.385,16,21,.762,104,42,92,.457,37,71,.521,5,21,.238,10,18,.556,99
31,2013-03-24,CHI,@,MIN,W 104-97,240,41,89,.461,31,63,.492,10,26,.385,12,17,.706,104,39,78,.500,33,66,.500,6,12,.500,13,19,.684,97
32,2013-04-12,MIL,@,ATL,L 104-109,240,38,92,.413,21,59,.356,17,33,.515,11,16,.688,104,43,85,.506,37,65,.569,6,20,.300,17,25,.680,109
33,2012-11-07,DET,@,SAC,L 103-105,240,36,73,.493,28,51,.549,8,22,.364,23,31,.742,103,40,82,.488,33,66,.500,7,16,.438,18,24,.750,105
34,2012-11-08,LAC,@,POR,W 103-90,240,41,77,.532,38,64,.594,3,13,.231,18,25,.720,103,32,75,.427,25,55,.455,7,20,.350,19,30,.633,90
35,2012-11-13,POR,@,SAC,W 103-86,240,35,72,.486,21,45,.467,14,27,.519,19,22,.864,103,36,77,.468,35,66,.530,1,11,.091,13,19,.684,86
36,2012-11-17,DAL,@,CLE,W 103-95,240,38,74,.514,28,51,.549,10,23,.435,17,20,.850,103,36,96,.375,28,71,.394,8,25,.320,15,20,.750,95
37,2012-11-23,NYK,@,HOU,L 103-131,240,37,86,.430,20,47,.426,17,39,.436,12,14,.857,103,46,89,.517,32,64,.500,14,25,.560,25,28,.893,131
38,2012-11-26,DEN,@,UTA,L 103-105,240,40,73,.548,35,59,.593,5,14,.357,18,32,.563,103,36,78,.462,28,56,.500,8,22,.364,25,34,.735,105
39,2012-11-30,DEN,@,LAL,L 103-122,240,40,86,.465,32,62,.516,8,24,.333,15,22,.682,103,47,87,.540,30,54,.556,17,33,.515,11,17,.647,122
40,2012-12-05,LAL,@,NOH,W 103-87,240,37,80,.463,24,52,.462,13,28,.464,16,22,.727,103,35,85,.412,28,66,.424,7,19,.368,10,18,.556,87
41,2012-12-14,SAC,@,OKC,L 103-113,240,34,75,.453,27,56,.482,7,19,.368,28,31,.903,103,41,83,.494,32,62,.516,9,21,.429,22,22,1.000,113
1,2012-12-19,PHI,@,HOU,L 103-125,240,40,89,.449,34,72,.472,6,17,.353,17,24,.708,103,42,75,.560,31,48,.646,11,27,.407,30,36,.833,125
2,2012-12-23,LAC,@,PHO,W 103-77,240,38,71,.535,27,50,.540,11,21,.524,16,29,.552,103,29,80,.363,26,63,.413,3,17,.176,16,24,.667,77
3,2013-01-01,PHI,@,LAL,W 103-99,240,41,86,.477,33,64,.516,8,22,.364,13,20,.650,103,37,94,.394,34,72,.472,3,22,.136,22,33,.667,99
4,2013-01-01,DAL,@,WAS,W 103-94,240,41,82,.500,31,60,.517,10,22,.455,11,17,.647,103,32,79,.405,22,53,.415,10,26,.385,20,26,.769,94
5,2013-01-08,ATL,@,MIN,L 103-108,240,38,77,.494,28,55,.509,10,22,.455,17,21,.810,103,40,87,.460,32,72,.444,8,15,.533,20,26,.769,108
6,2013-01-11,DET,@,MIL,W 103-87,240,39,90,.433,31,68,.456,8,22,.364,17,25,.680,103,36,91,.396,35,75,.467,1,16,.063,14,19,.737,87
7,2013-01-15,IND,@,CHA,W 103-76,240,36,87,.414,28,65,.431,8,22,.364,23,28,.821,103,25,72,.347,22,63,.349,3,9,.333,23,30,.767,76
8,2013-01-20,LAL,@,TOR,L 103-108,240,38,88,.432,29,61,.475,9,27,.333,18,21,.857,103,46,84,.548,40,64,.625,6,20,.300,10,17,.588,108
9,2013-01-28,MEM,@,PHI,W 103-100,240,40,73,.548,32,60,.533,8,13,.615,15,19,.789,103,45,83,.542,41,74,.554,4,9,.444,6,9,.667,100
10,2013-02-05,ATL,@,IND,L 103-114,240,36,81,.444,28,60,.467,8,21,.381,23,28,.821,103,36,75,.480,25,50,.500,11,25,.440,31,40,.775,114
11,2013-02-08,POR,@,HOU,L 103-118,240,40,88,.455,32,62,.516,8,26,.308,15,20,.750,103,47,79,.595,35,53,.660,12,26,.462,12,16,.750,118
12,2013-02-11,SAS,@,CHI,W 103-89,240,39,75,.520,31,59,.525,8,16,.500,17,20,.850,103,37,78,.474,35,66,.530,2,12,.167,13,20,.650,89
13,2013-02-20,MIA,@,ATL,W 103-90,240,37,78,.474,27,55,.491,10,23,.435,19,25,.760,103,36,72,.500,29,46,.630,7,26,.269,11,16,.688,90
14,2013-02-23,ATL,@,MIL,W 103-102,240,39,91,.429,25,63,.397,14,28,.500,11,14,.786,103,41,89,.461,37,77,.481,4,12,.333,16,20,.800,102
15,2013-02-23,HOU,@,WAS,L 103-105,240,38,84,.452,19,38,.500,19,46,.413,8,14,.571,103,41,80,.513,34,64,.531,7,16,.438,16,19,.842,105
16,2013-02-24,LAL,@,DAL,W 103-99,240,34,72,.472,21,47,.447,13,25,.520,22,31,.710,103,39,87,.448,31,69,.449,8,18,.444,13,19,.684,99
17,2013-03-01,OKC,@,DEN,L 103-105,240,36,83,.434,29,63,.460,7,20,.350,24,34,.706,103,43,95,.453,36,74,.486,7,21,.333,12,17,.706,105
18,2013-03-03,DAL,@,HOU,L 103-136,240,38,80,.475,26,53,.491,12,27,.444,15,24,.625,103,46,80,.575,32,46,.696,14,34,.412,30,40,.750,136
19,2013-03-08,MEM,@,CLE,W 103-92,240,45,86,.523,41,75,.547,4,11,.364,9,11,.818,103,33,72,.458,27,58,.466,6,14,.429,20,26,.769,92
20,2013-03-09,MIL,@,GSW,W 103-93,240,38,78,.487,25,50,.500,13,28,.464,14,19,.737,103,37,82,.451,31,67,.463,6,15,.400,13,20,.650,93
21,2013-03-22,WAS,@,LAL,W 103-100,240,40,87,.460,29,61,.475,11,26,.423,12,16,.750,103,39,81,.481,28,58,.483,11,23,.478,11,17,.647,100
22,2013-03-25,LAL,@,GSW,L 103-109,240,36,91,.396,30,65,.462,6,26,.231,25,36,.694,103,43,90,.478,33,67,.493,10,23,.435,13,19,.684,109
23,2013-03-28,IND,@,DAL,W 103-78,240,40,84,.476,33,69,.478,7,15,.467,16,26,.615,103,32,83,.386,28,69,.406,4,14,.286,10,14,.714,78
24,2013-03-28,LAL,@,MIL,L 103-113,240,34,77,.442,29,57,.509,5,20,.250,30,39,.769,103,45,93,.484,38,74,.514,7,19,.368,16,22,.727,113
25,2013-03-30,LAL,@,SAC,W 103-98,240,38,82,.463,28,52,.538,10,30,.333,17,26,.654,103,39,86,.453,32,62,.516,7,24,.292,13,16,.813,98
26,2013-04-01,ORL,@,HOU,L 103-111,240,39,93,.419,33,78,.423,6,15,.400,19,21,.905,103,44,98,.449,35,69,.507,9,29,.310,14,22,.636,111
27,2013-04-10,MIL,@,ORL,L 103-113,265,39,101,.386,31,73,.425,8,28,.286,17,26,.654,103,51,109,.468,43,94,.457,8,15,.533,3,8,.375,113
28,2013-04-10,MIA,@,WAS,W 103-98,240,33,75,.440,16,34,.471,17,41,.415,20,23,.870,103,36,80,.450,25,57,.439,11,23,.478,15,21,.714,98
29,2013-04-15,MEM,@,DAL,W 103-97,240,38,80,.475,31,59,.525,7,21,.333,20,25,.800,103,34,76,.447,25,57,.439,9,19,.474,20,25,.800,97
30,2012-11-03,CLE,@,MIL,L 102-105,240,39,83,.470,33,67,.493,6,16,.375,18,29,.621,102,41,79,.519,32,55,.582,9,24,.375,14,21,.667,105
31,2012-11-16,PHO,@,LAL,L 102-114,240,45,92,.489,40,78,.513,5,14,.357,7,15,.467,102,42,89,.472,34,68,.500,8,21,.381,22,28,.786,114
32,2012-11-20,NYK,@,NOH,W 102-80,240,37,83,.446,23,47,.489,14,36,.389,14,19,.737,102,29,69,.420,21,51,.412,8,18,.444,14,21,.667,80
33,2012-11-23,SAC,@,UTA,L 102-104,240,40,80,.500,30,63,.476,10,17,.588,12,16,.750,102,36,83,.434,33,68,.485,3,15,.200,29,33,.879,104
34,2012-11-28,NYK,@,MIL,W 102-88,240,35,73,.479,24,52,.462,11,21,.524,21,25,.840,102,33,72,.458,28,59,.475,5,13,.385,17,21,.810,88
35,2012-12-03,ORL,@,GSW,W 102-94,240,40,92,.435,32,69,.464,8,23,.348,14,16,.875,102,37,81,.457,30,64,.469,7,17,.412,13,18,.722,94
36,2012-12-14,LAL,@,WAS,W 102-96,240,37,82,.451,29,53,.547,8,29,.276,20,28,.714,102,36,83,.434,28,62,.452,8,21,.381,16,20,.800,96
37,2012-12-15,CLE,@,NYK,L 102-103,240,40,82,.488,31,58,.534,9,24,.375,13,17,.765,102,37,85,.435,24,50,.480,13,35,.371,16,23,.696,103
38,2012-12-28,ATL,@,CLE,W 102-94,240,38,78,.487,25,54,.463,13,24,.542,13,16,.813,102,36,86,.419,28,65,.431,8,21,.381,14,14,1.000,94
39,2013-01-04,LAL,@,LAC,L 102-107,240,35,76,.461,29,51,.569,6,25,.240,26,36,.722,102,41,82,.500,35,68,.515,6,14,.429,19,25,.760,107
40,2013-01-05,POR,@,MIN,W 102-97,240,37,86,.430,21,62,.339,16,24,.667,12,13,.923,102,38,91,.418,33,75,.440,5,16,.313,16,18,.889,97
41,2013-01-07,BOS,@,NYK,W 102-96,240,39,74,.527,33,56,.589,6,18,.333,18,20,.900,102,31,76,.408,17,44,.386,14,32,.438,20,26,.769,96
42,2013-01-14,OKC,@,PHO,W 102-90,240,40,84,.476,35,67,.522,5,17,.294,17,22,.773,102,35,84,.417,26,59,.441,9,25,.360,11,18,.611,90
43,2013-01-17,NYK,@,DET,W 102-87,240,33,72,.458,22,41,.537,11,31,.355,25,31,.806,102,35,79,.443,29,62,.468,6,17,.353,11,22,.500,87
44,2013-01-22,PHI,@,MIL,L 102-110,240,42,95,.442,34,79,.430,8,16,.500,10,13,.769,102,41,79,.519,34,63,.540,7,16,.438,21,33,.636,110
45,2013-01-23,NOH,@,SAS,L 102-106,240,38,81,.469,28,64,.438,10,17,.588,16,23,.696,102,43,80,.538,35,55,.636,8,25,.320,12,23,.522,106
46,2013-01-26,GSW,@,MIL,L 102-109,240,39,93,.419,26,65,.400,13,28,.464,11,11,1.000,102,41,101,.406,28,71,.394,13,30,.433,14,20,.700,109
47,2013-02-10,LAC,@,NYK,W 102-88,240,41,80,.513,31,52,.596,10,28,.357,10,16,.625,102,33,74,.446,26,51,.510,7,23,.304,15,18,.833,88
48,2013-02-11,WAS,@,MIL,W 102-90,240,42,74,.568,38,62,.613,4,12,.333,14,17,.824,102,36,95,.379,31,72,.431,5,23,.217,13,22,.591,90
49,2013-02-19,PHO,@,POR,W 102-98,240,41,82,.500,38,69,.551,3,13,.231,17,20,.850,102,33,80,.413,27,60,.450,6,20,.300,26,32,.813,98
1,2013-02-27,ATL,@,UTA,W 102-91,240,38,78,.487,33,61,.541,5,17,.294,21,26,.808,102,37,83,.446,33,68,.485,4,15,.267,13,23,.565,91
2,2013-03-01,SAC,@,SAS,L 102-130,240,39,85,.459,32,64,.500,7,21,.333,17,19,.895,102,51,84,.607,42,64,.656,9,20,.450,19,23,.826,130
3,2013-03-04,NYK,@,CLE,W 102-97,240,36,78,.462,24,48,.500,12,30,.400,18,21,.857,102,37,73,.507,31,53,.585,6,20,.300,17,24,.708,97
4,2013-03-08,ATL,@,BOS,L 102-107,265,40,88,.455,31,61,.508,9,27,.333,13,17,.765,102,40,78,.513,30,58,.517,10,20,.500,17,20,.850,107
5,2013-03-08,DAL,@,DET,W 102-99,240,41,78,.526,30,56,.536,11,22,.500,9,15,.600,102,39,96,.406,30,66,.455,9,30,.300,12,19,.632,99
6,2013-03-12,MEM,@,POR,W 102-97,240,39,76,.513,36,65,.554,3,11,.273,21,31,.677,102,32,79,.405,27,63,.429,5,16,.313,28,29,.966,97
7,2013-03-17,SAC,@,LAL,L 102-113,240,42,96,.438,32,65,.492,10,31,.323,8,8,1.000,102,41,72,.569,29,44,.659,12,28,.429,19,29,.655,113
8,2013-03-24,BRK,@,PHO,W 102-100,240,35,76,.461,31,62,.500,4,14,.286,28,31,.903,102,41,99,.414,35,78,.449,6,21,.286,12,17,.706,100
9,2013-03-26,LAC,@,DAL,L 102-109,265,38,85,.447,28,52,.538,10,33,.303,16,25,.640,102,40,82,.488,34,59,.576,6,23,.261,23,27,.852,109
10,2013-03-29,CHA,@,NYK,L 102-111,240,34,73,.466,24,47,.511,10,26,.385,24,31,.774,102,38,77,.494,29,58,.500,9,19,.474,26,30,.867,111
11,2013-03-29,LAC,@,SAS,L 102-104,240,41,81,.506,33,62,.532,8,19,.421,12,21,.571,102,39,74,.527,33,59,.559,6,15,.400,20,21,.952,104
12,2013-04-01,CHA,@,MIL,L 102-131,240,37,73,.507,31,54,.574,6,19,.316,22,28,.786,102,51,100,.510,37,73,.507,14,27,.519,15,17,.882,131
13,2013-04-01,POR,@,UTA,L 102-112,240,39,67,.582,26,44,.591,13,23,.565,11,17,.647,102,45,83,.542,36,61,.590,9,22,.409,13,18,.722,112
14,2013-04-02,NYK,@,MIA,W 102-90,240,37,71,.521,23,44,.523,14,27,.519,14,20,.700,102,30,60,.500,22,40,.550,8,20,.400,22,27,.815,90
15,2013-04-10,PHO,@,DAL,W 102-91,240,37,89,.416,25,62,.403,12,27,.444,16,17,.941,102,34,85,.400,28,68,.412,6,17,.353,17,21,.810,91
16,2013-04-15,CHI,@,ORL,W 102-84,240,42,75,.560,33,58,.569,9,17,.529,9,13,.692,102,31,74,.419,29,64,.453,2,10,.200,20,33,.606,84
17,2012-11-09,MIL,@,WAS,W 101-91,240,40,78,.513,34,63,.540,6,15,.400,15,19,.789,101,34,78,.436,30,60,.500,4,18,.222,19,22,.864,91
18,2012-11-12,BOS,@,CHI,W 101-95,240,41,81,.506,38,65,.585,3,16,.188,16,16,1.000,101,34,74,.459,31,65,.477,3,9,.333,24,31,.774,95
19,2012-11-13,CLE,@,BRK,L 101-114,240,38,87,.437,35,73,.479,3,14,.214,22,26,.846,101,42,77,.545,37,55,.673,5,22,.227,25,31,.806,114
20,2012-11-14,WAS,@,DAL,L 101-107,240,39,81,.481,26,54,.481,13,27,.481,10,11,.909,101,39,78,.500,36,67,.537,3,11,.273,26,33,.788,107
21,2012-11-21,DEN,@,MIN,W 101-94,240,35,79,.443,26,58,.448,9,21,.429,22,26,.846,101,34,89,.382,24,61,.393,10,28,.357,16,25,.640,94
22,2012-11-23,ATL,@,CHA,W 101-91,240,42,78,.538,31,56,.554,11,22,.500,6,14,.429,101,31,83,.373,23,61,.377,8,22,.364,21,26,.808,91
23,2012-11-25,PHO,@,PHI,L 101-104,240,39,83,.470,35,72,.486,4,11,.364,19,20,.950,101,39,81,.481,30,62,.484,9,19,.474,17,23,.739,104
24,2012-11-26,POR,@,DET,L 101-108,240,36,85,.424,30,66,.455,6,19,.316,23,31,.742,101,42,80,.525,33,65,.508,9,15,.600,15,22,.682,108
25,2012-11-27,TOR,@,HOU,L 101-117,240,42,86,.488,34,63,.540,8,23,.348,9,12,.750,101,44,83,.530,31,57,.544,13,26,.500,16,21,.762,117
26,2012-12-04,MIA,@,WAS,L 101-105,240,41,89,.461,33,61,.541,8,28,.286,11,16,.688,101,38,79,.481,31,60,.517,7,19,.368,22,29,.759,105
27,2012-12-08,GSW,@,WAS,W 101-97,240,35,81,.432,26,59,.441,9,22,.409,22,27,.815,101,37,87,.425,28,62,.452,9,25,.360,14,23,.609,97
28,2012-12-11,DEN,@,DET,W 101-94,240,37,80,.463,31,63,.492,6,17,.353,21,34,.618,101,34,81,.420,29,68,.426,5,13,.385,21,31,.677,94
29,2013-01-03,MIN,@,DEN,W 101-97,240,37,83,.446,31,67,.463,6,16,.375,21,30,.700,101,40,86,.465,34,64,.531,6,22,.273,11,20,.550,97
30,2013-01-18,TOR,@,PHI,L 101-108,265,40,88,.455,29,63,.460,11,25,.440,10,13,.769,101,47,91,.516,43,72,.597,4,19,.211,10,14,.714,108
31,2013-01-25,MIN,@,WAS,L 101-114,240,39,88,.443,36,74,.486,3,14,.214,20,33,.606,101,48,83,.578,40,66,.606,8,17,.471,10,17,.588,114
32,2013-01-26,MIN,@,CHA,L 101-102,240,37,77,.481,27,57,.474,10,20,.500,17,23,.739,101,37,73,.507,32,62,.516,5,11,.455,23,26,.885,102
33,2013-01-28,IND,@,DEN,L 101-102,240,39,85,.459,28,62,.452,11,23,.478,12,17,.706,101,37,78,.474,30,64,.469,7,14,.500,21,30,.700,102
34,2013-02-04,CHI,@,IND,L 101-111,240,39,88,.443,35,72,.486,4,16,.250,19,22,.864,101,39,74,.527,33,60,.550,6,14,.429,27,34,.794,111
35,2013-02-12,SAC,@,MEM,L 101-108,240,40,86,.465,36,70,.514,4,16,.250,17,24,.708,101,41,75,.547,35,62,.565,6,13,.462,20,24,.833,108
36,2013-02-19,GSW,@,UTA,L 101-115,240,39,83,.470,34,66,.515,5,17,.294,18,24,.750,101,39,78,.500,29,57,.509,10,21,.476,27,33,.818,115
37,2013-02-22,SAS,@,GSW,L 101-107,265,37,95,.389,33,73,.452,4,22,.182,23,32,.719,101,39,94,.415,34,73,.466,5,21,.238,24,30,.800,107
38,2013-02-26,CLE,@,CHI,W 101-98,240,40,81,.494,35,64,.547,5,17,.294,16,19,.842,101,39,78,.500,30,57,.526,9,21,.429,11,15,.733,98
39,2013-02-26,BRK,@,NOH,W 101-97,240,37,76,.487,25,56,.446,12,20,.600,15,18,.833,101,40,87,.460,35,73,.479,5,14,.357,12,15,.800,97
40,2013-03-06,UTA,@,CLE,L 101-104,240,38,87,.437,29,68,.426,9,19,.474,16,19,.842,101,37,90,.411,30,74,.405,7,16,.438,23,29,.793,104
41,2013-03-06,MIL,@,LAC,L 101-117,240,38,79,.481,25,50,.500,13,29,.448,12,15,.800,101,47,87,.540,35,58,.603,12,29,.414,11,14,.786,117
42,2013-03-16,DET,@,POR,L 101-112,240,40,76,.526,35,59,.593,5,17,.294,16,24,.667,101,41,86,.477,34,67,.507,7,19,.368,23,24,.958,112
43,2013-03-19,LAC,@,SAC,L 101-116,240,36,80,.450,27,54,.500,9,26,.346,20,26,.769,101,37,73,.507,23,45,.511,14,28,.500,28,34,.824,116
44,2013-03-20,TOR,@,CHA,L 101-107,240,35,83,.422,30,61,.492,5,22,.227,26,26,1.000,101,35,75,.467,27,59,.458,8,16,.500,29,40,.725,107
45,2013-03-27,MEM,@,NYK,L 101-108,240,33,70,.471,27,49,.551,6,21,.286,29,35,.829,101,38,74,.514,25,43,.581,13,31,.419,19,22,.864,108
46,2013-04-03,PHO,@,LAC,L 101-126,240,35,77,.455,28,60,.467,7,17,.412,24,25,.960,101,52,93,.559,43,72,.597,9,21,.429,13,18,.722,126
1,2013-04-05,PHI,@,ATL,W 101-90,240,37,80,.463,28,64,.438,9,16,.563,18,24,.750,101,34,73,.466,29,56,.518,5,17,.294,17,27,.630,90
2,2013-04-06,DET,@,MIN,L 101-107,240,40,75,.533,34,60,.567,6,15,.400,15,21,.714,101,36,83,.434,30,69,.435,6,14,.429,29,38,.763,107
3,2013-04-09,TOR,@,CHI,W 101-98,240,37,72,.514,30,54,.556,7,18,.389,20,24,.833,101,37,86,.430,27,69,.391,10,17,.588,14,20,.700,98
4,2013-04-10,BRK,@,BOS,W 101-93,240,34,74,.459,26,55,.473,8,19,.421,25,28,.893,101,37,81,.457,31,65,.477,6,16,.375,13,17,.765,93
5,2013-04-12,NYK,@,CLE,W 101-91,240,40,79,.506,30,51,.588,10,28,.357,11,17,.647,101,34,79,.430,28,57,.491,6,22,.273,17,24,.708,91
6,2013-04-12,BOS,@,MIA,L 101-109,240,41,85,.482,35,62,.565,6,23,.261,13,13,1.000,101,39,71,.549,27,48,.563,12,23,.522,19,28,.679,109
7,2013-04-12,SAC,@,SAS,L 101-108,240,39,89,.438,28,69,.406,11,20,.550,12,15,.800,101,42,77,.545,36,60,.600,6,17,.353,18,21,.857,108
8,2013-04-15,WAS,@,BRK,L 101-106,240,41,77,.532,37,66,.561,4,11,.364,15,20,.750,101,43,92,.467,36,77,.468,7,15,.467,13,27,.481,106
9,2013-04-15,PHI,@,DET,L 101-109,240,39,87,.448,33,65,.508,6,22,.273,17,21,.810,101,41,83,.494,32,58,.552,9,25,.360,18,22,.818,109
10,2012-11-03,TOR,@,BRK,L 100-107,240,37,82,.451,30,64,.469,7,18,.389,19,25,.760,100,37,81,.457,31,66,.470,6,15,.400,27,37,.730,107
11,2012-11-03,UTA,@,SAS,L 100-110,240,38,77,.494,33,64,.516,5,13,.385,19,22,.864,100,42,74,.568,35,61,.574,7,13,.538,19,23,.826,110
12,2012-11-12,DEN,@,PHO,L 100-110,240,41,76,.539,34,60,.567,7,16,.438,11,18,.611,100,43,94,.457,36,82,.439,7,12,.583,17,21,.810,110
13,2012-11-14,MIA,@,LAC,L 100-107,240,35,77,.455,26,56,.464,9,21,.429,21,29,.724,100,35,72,.486,25,51,.490,10,21,.476,27,32,.844,107
14,2012-11-17,DEN,@,SAS,L 100-126,240,39,78,.500,35,67,.522,4,11,.364,18,26,.692,100,47,88,.534,31,61,.508,16,27,.593,16,20,.800,126
15,2012-11-21,WAS,@,ATL,L 100-101,265,38,89,.427,31,69,.449,7,20,.350,17,24,.708,100,40,92,.435,31,67,.463,9,25,.360,12,21,.571,101
16,2012-11-23,OKC,@,BOS,L 100-108,240,37,79,.468,31,55,.564,6,24,.250,20,24,.833,100,39,80,.488,30,63,.476,9,17,.529,21,24,.875,108
17,2012-11-25,DET,@,NYK,L 100-121,240,37,78,.474,28,58,.483,9,20,.450,17,22,.773,100,38,79,.481,21,46,.457,17,33,.515,28,31,.903,121
18,2012-11-29,SAS,@,MIA,L 100-105,240,36,80,.450,26,50,.520,10,30,.333,18,24,.750,100,42,86,.488,37,73,.507,5,13,.385,16,19,.842,105
19,2012-12-01,OKC,@,NOH,W 100-79,240,40,79,.506,33,63,.524,7,16,.438,13,17,.765,100,30,81,.370,24,57,.421,6,24,.250,13,18,.722,79
20,2012-12-05,NYK,@,CHA,W 100-98,240,39,92,.424,26,51,.510,13,41,.317,9,13,.692,100,39,83,.470,32,67,.478,7,16,.438,13,15,.867,98
21,2012-12-05,TOR,@,SAC,L 100-107,240,35,86,.407,29,63,.460,6,23,.261,24,28,.857,100,38,82,.463,32,67,.478,6,15,.400,25,34,.735,107
22,2012-12-11,NYK,@,BRK,W 100-97,240,36,78,.462,22,50,.440,14,28,.500,14,18,.778,100,36,68,.529,32,50,.640,4,18,.222,21,28,.750,97
23,2012-12-12,LAC,@,CHA,W 100-94,240,37,85,.435,28,62,.452,9,23,.391,17,25,.680,100,35,82,.427,30,66,.455,5,16,.313,19,24,.792,94
24,2012-12-18,PHI,@,DAL,L 100-107,240,37,86,.430,24,51,.471,13,35,.371,13,15,.867,100,39,72,.542,35,61,.574,4,11,.364,25,29,.862,107
25,2012-12-18,CHA,@,LAL,L 100-101,240,38,95,.400,28,71,.394,10,24,.417,14,22,.636,100,35,88,.398,25,57,.439,10,31,.323,21,27,.778,101
26,2012-12-18,ATL,@,WAS,W 100-95,265,34,78,.436,25,54,.463,9,24,.375,23,34,.676,100,36,95,.379,30,77,.390,6,18,.333,17,22,.773,95
27,2012-12-19,OKC,@,ATL,W 100-92,240,36,84,.429,27,59,.458,9,25,.360,19,20,.950,100,36,94,.383,27,70,.386,9,24,.375,11,17,.647,92
28,2012-12-21,CHA,@,GSW,L 100-115,240,33,90,.367,25,69,.362,8,21,.381,26,35,.743,100,44,85,.518,30,58,.517,14,27,.519,13,16,.813,115
29,2012-12-25,DEN,@,LAC,L 100-112,240,40,80,.500,37,67,.552,3,13,.231,17,24,.708,100,45,93,.484,34,68,.500,11,25,.440,11,19,.579,112
30,2012-12-29,IND,@,ATL,L 100-109,240,38,80,.475,33,65,.508,5,15,.333,19,22,.864,100,44,80,.550,34,60,.567,10,20,.500,11,14,.786,109
31,2012-12-29,CLE,@,BRK,L 100-103,240,38,82,.463,29,62,.468,9,20,.450,15,19,.789,100,35,75,.467,31,60,.517,4,15,.267,29,39,.744,103
32,2013-01-12,HOU,@,PHI,L 100-107,240,37,84,.440,29,52,.558,8,32,.250,18,22,.818,100,43,87,.494,37,69,.536,6,18,.333,15,19,.789,107
33,2013-01-16,HOU,@,DAL,L 100-105,240,33,84,.393,22,57,.386,11,27,.407,23,30,.767,100,33,86,.384,28,64,.438,5,22,.227,34,43,.791,105
34,2013-01-18,CHI,@,BOS,W 100-99,265,36,75,.480,31,60,.517,5,15,.333,23,32,.719,100,38,91,.418,35,77,.455,3,14,.214,20,28,.714,99
35,2013-01-21,HOU,@,CHA,W 100-94,240,29,74,.392,19,45,.422,10,29,.345,32,41,.780,100,34,81,.420,28,66,.424,6,15,.400,20,24,.833,94
36,2013-01-25,HOU,@,NOH,W 100-82,240,34,71,.479,23,50,.460,11,21,.524,21,26,.808,100,31,80,.388,28,60,.467,3,20,.150,17,20,.850,82
37,2013-01-26,LAC,@,POR,L 100-101,240,40,81,.494,33,65,.508,7,16,.438,13,17,.765,100,35,75,.467,24,50,.480,11,25,.440,20,21,.952,101
38,2013-02-03,MIA,@,TOR,W 100-85,240,40,75,.533,37,63,.587,3,12,.250,17,23,.739,100,28,75,.373,24,57,.421,4,18,.222,25,32,.781,85
39,2013-02-04,POR,@,MIN,W 100-98,240,41,70,.586,34,52,.654,7,18,.389,11,16,.688,100,40,85,.471,37,72,.514,3,13,.231,15,19,.789,98
40,2013-02-08,LAL,@,CHA,W 100-93,240,36,80,.450,28,54,.519,8,26,.308,20,25,.800,100,38,89,.427,34,75,.453,4,14,.286,13,19,.684,93
41,2013-02-08,TOR,@,IND,W 100-98,265,42,96,.438,40,87,.460,2,9,.222,14,19,.737,100,35,78,.449,26,56,.464,9,22,.409,19,28,.679,98
42,2013-02-08,NYK,@,MIN,W 100-94,240,38,81,.469,30,55,.545,8,26,.308,16,20,.800,100,37,80,.463,36,67,.537,1,13,.077,19,27,.704,94
43,2013-02-11,MIN,@,CLE,W 100-92,240,39,75,.520,31,61,.508,8,14,.571,14,17,.824,100,40,79,.506,35,61,.574,5,18,.278,7,11,.636,92
44,2013-02-13,SAC,@,DAL,L 100-123,240,33,80,.413,29,64,.453,4,16,.250,30,36,.833,100,43,92,.467,30,58,.517,13,34,.382,24,26,.923,123
45,2013-02-20,NOH,@,CLE,L 100-105,240,37,76,.487,30,61,.492,7,15,.467,19,22,.864,100,38,77,.494,33,63,.524,5,14,.357,24,34,.706,105
46,2013-02-24,GSW,@,MIN,W 100-99,240,37,81,.457,30,64,.469,7,17,.412,19,23,.826,100,37,85,.435,36,74,.486,1,11,.091,24,31,.774,99
47,2013-03-10,DAL,@,MIN,W 100-77,240,42,92,.457,34,71,.479,8,21,.381,8,10,.800,100,32,88,.364,30,70,.429,2,18,.111,11,14,.786,77
48,2013-03-15,MIN,@,HOU,L 100-108,240,39,81,.481,33,57,.579,6,24,.250,16,20,.800,100,36,74,.486,25,43,.581,11,31,.355,25,31,.806,108
49,2013-03-18,POR,@,PHI,L 100-101,240,38,90,.422,26,62,.419,12,28,.429,12,14,.857,100,43,86,.500,38,70,.543,5,16,.313,10,13,.769,101
50,2013-03-21,PHI,@,DEN,L 100-101,240,43,78,.551,36,60,.600,7,18,.389,7,11,.636,100,37,76,.487,30,65,.462,7,11,.636,20,27,.741,101
51,2013-03-26,NYK,@,BOS,W 100-85,240,39,90,.433,31,62,.500,8,28,.286,14,18,.778,100,31,69,.449,25,49,.510,6,20,.300,17,22,.773,85
52,2013-03-27,IND,@,HOU,W 100-91,240,35,78,.449,29,60,.483,6,18,.333,24,28,.857,100,32,83,.386,26,62,.419,6,21,.286,21,26,.808,91
53,2013-04-01,BOS,@,MIN,L 100-110,240,42,81,.519,35,65,.538,7,16,.438,9,14,.643,100,40,83,.482,35,65,.538,5,18,.278,25,27,.926,110
54,2013-04-12,MIN,@,UTA,L 100-107,240,36,78,.462,28,56,.500,8,22,.364,20,21,.952,100,42,72,.583,34,59,.576,8,13,.615,15,17,.882,107
1,2013-04-14,SAC,@,HOU,L 100-121,240,39,100,.390,31,75,.413,8,25,.320,14,17,.824,100,45,83,.542,32,56,.571,13,27,.481,18,24,.750,121
2,2012-10-30,DAL,@,LAL,W 99-91,240,40,85,.471,35,70,.500,5,15,.333,14,18,.778,99,38,77,.494,35,64,.547,3,13,.231,12,31,.387,91
3,2012-10-31,SAS,@,NOH,W 99-95,240,38,80,.475,32,60,.533,6,20,.300,17,26,.654,99,35,80,.438,31,63,.492,4,17,.235,21,23,.913,95
4,2012-11-02,MIL,@,BOS,W 99-88,240,40,86,.465,32,68,.471,8,18,.444,11,12,.917,99,33,74,.446,28,60,.467,5,14,.357,17,21,.810,88
5,2012-11-03,CHA,@,DAL,L 99-126,240,39,91,.429,36,74,.486,3,17,.176,18,24,.750,99,49,80,.613,33,55,.600,16,25,.640,12,15,.800,126
6,2012-11-05,PHO,@,MIA,L 99-124,240,35,88,.398,28,67,.418,7,21,.333,22,29,.759,99,47,86,.547,32,60,.533,15,26,.577,15,19,.789,124
7,2012-11-09,CHA,@,NOH,L 99-107,240,40,83,.482,33,62,.532,7,21,.333,12,18,.667,99,43,83,.518,35,61,.574,8,22,.364,13,21,.619,107
8,2012-11-13,NYK,@,ORL,W 99-89,240,41,84,.488,32,60,.533,9,24,.375,8,11,.727,99,37,75,.493,32,61,.525,5,14,.357,10,17,.588,89
9,2012-11-18,BRK,@,SAC,W 99-90,240,36,75,.480,31,58,.534,5,17,.294,22,25,.880,99,37,80,.463,31,62,.500,6,18,.333,10,19,.526,90
10,2012-12-02,PHO,@,NYK,L 99-106,240,39,80,.488,31,57,.544,8,23,.348,13,19,.684,99,40,90,.444,28,61,.459,12,29,.414,14,17,.824,106
11,2012-12-05,MIL,@,SAS,L 99-110,240,35,84,.417,30,72,.417,5,12,.417,24,29,.828,99,40,85,.471,34,64,.531,6,21,.286,24,28,.857,110
12,2012-12-07,TOR,@,UTA,L 99-131,240,33,82,.402,26,58,.448,7,24,.292,26,31,.839,99,45,91,.495,32,68,.471,13,23,.565,28,35,.800,131
13,2012-12-08,PHO,@,LAC,L 99-117,240,36,78,.462,27,54,.500,9,24,.375,18,20,.900,99,48,93,.516,41,70,.586,7,23,.304,14,24,.583,117
14,2012-12-08,SAC,@,POR,W 99-80,240,36,86,.419,27,67,.403,9,19,.474,18,22,.818,99,29,75,.387,21,54,.389,8,21,.381,14,18,.778,80
15,2012-12-15,MEM,@,UTA,W 99-86,240,38,85,.447,34,74,.459,4,11,.364,19,24,.792,99,31,74,.419,26,57,.456,5,17,.294,19,24,.792,86
16,2012-12-21,MIL,@,BOS,W 99-94,265,36,83,.434,31,67,.463,5,16,.313,22,36,.611,99,36,94,.383,31,70,.443,5,24,.208,17,20,.850,94
17,2012-12-21,IND,@,CLE,W 99-89,240,39,80,.488,34,64,.531,5,16,.313,16,25,.640,99,32,80,.400,27,64,.422,5,16,.313,20,26,.769,89
18,2012-12-26,PHI,@,MEM,W 99-89,240,37,71,.521,28,55,.509,9,16,.563,16,23,.696,99,35,90,.389,30,75,.400,5,15,.333,14,17,.824,89
19,2012-12-26,NYK,@,PHO,W 99-97,240,40,88,.455,31,66,.470,9,22,.409,10,14,.714,99,38,83,.458,30,62,.484,8,21,.381,13,16,.813,97
20,2012-12-28,MIA,@,DET,L 99-109,240,39,77,.506,30,48,.625,9,29,.310,12,16,.750,99,43,74,.581,31,55,.564,12,19,.632,11,17,.647,109
21,2013-01-05,NOH,@,DAL,W 99-96,265,39,86,.453,31,65,.477,8,21,.381,13,16,.813,99,39,85,.459,32,66,.485,7,19,.368,11,13,.846,96
22,2013-01-07,OKC,@,WAS,L 99-101,240,34,80,.425,28,55,.509,6,25,.240,25,30,.833,99,38,87,.437,28,69,.406,10,18,.556,15,18,.833,101
23,2013-01-08,PHO,@,MIL,L 99-108,240,37,90,.411,33,70,.471,4,20,.200,21,26,.808,99,42,91,.462,33,74,.446,9,17,.529,15,19,.789,108
24,2013-01-14,LAC,@,MEM,W 99-73,240,35,76,.461,30,62,.484,5,14,.357,24,32,.750,99,27,89,.303,21,69,.304,6,20,.300,13,17,.765,73
25,2013-01-17,MIA,@,LAL,W 99-90,240,40,83,.482,38,70,.543,2,13,.154,17,23,.739,99,31,72,.431,21,50,.420,10,22,.455,18,28,.643,90
26,2013-01-21,LAC,@,GSW,L 99-106,240,38,83,.458,27,53,.509,11,30,.367,12,22,.545,99,39,75,.520,27,53,.509,12,22,.545,16,18,.889,106
27,2013-01-23,OKC,@,GSW,L 99-104,240,36,78,.462,31,62,.500,5,16,.313,22,27,.815,99,37,84,.440,31,61,.508,6,23,.261,24,27,.889,104
28,2013-01-26,PHO,@,SAS,L 99-108,240,41,81,.506,35,69,.507,6,12,.500,11,14,.786,99,41,83,.494,34,59,.576,7,24,.292,19,23,.826,108
29,2013-01-26,CLE,@,TOR,W 99-98,240,37,78,.474,31,67,.463,6,11,.545,19,22,.864,99,40,82,.488,35,65,.538,5,17,.294,13,18,.722,98
30,2013-01-30,NOH,@,UTA,L 99-104,240,37,78,.474,29,56,.518,8,22,.364,17,28,.607,99,34,68,.500,30,56,.536,4,12,.333,32,46,.696,104
31,2013-02-01,CLE,@,DET,L 99-117,240,35,88,.398,29,68,.426,6,20,.300,23,26,.885,99,45,83,.542,41,69,.594,4,14,.286,23,43,.535,117
32,2013-02-02,UTA,@,POR,L 99-105,240,39,90,.433,31,71,.437,8,19,.421,13,16,.813,99,38,75,.507,28,57,.491,10,18,.556,19,28,.679,105
33,2013-02-06,POR,@,DAL,L 99-105,240,36,84,.429,26,54,.481,10,30,.333,17,19,.895,99,41,86,.477,31,66,.470,10,20,.500,13,19,.684,105
34,2013-02-06,BOS,@,TOR,W 99-95,240,35,73,.479,31,54,.574,4,19,.211,25,30,.833,99,34,82,.415,30,64,.469,4,18,.222,23,26,.885,95
35,2013-02-20,BOS,@,LAL,L 99-113,240,39,82,.476,30,62,.484,9,20,.450,12,20,.600,99,42,83,.506,35,61,.574,7,22,.318,22,31,.710,113
36,2013-02-28,LAC,@,IND,W 99-91,240,39,80,.488,35,57,.614,4,23,.174,17,21,.810,99,32,75,.427,23,50,.460,9,25,.360,18,25,.720,91
37,2013-03-03,MIA,@,NYK,W 99-93,240,39,84,.464,31,64,.484,8,20,.400,13,19,.684,99,32,74,.432,24,45,.533,8,29,.276,21,26,.808,93
38,2013-03-06,BRK,@,CHA,W 99-78,240,34,67,.507,21,40,.525,13,27,.481,18,22,.818,99,32,84,.381,28,66,.424,4,18,.222,10,15,.667,78
39,2013-03-15,LAL,@,IND,W 99-93,240,33,78,.423,20,52,.385,13,26,.500,20,30,.667,99,37,99,.374,25,72,.347,12,27,.444,7,9,.778,93
40,2013-03-21,POR,@,CHI,W 99-89,240,41,84,.488,31,63,.492,10,21,.476,7,10,.700,99,39,89,.438,35,75,.467,4,14,.286,7,11,.636,89
41,2013-03-22,NYK,@,TOR,W 99-94,240,38,71,.535,28,49,.571,10,22,.455,13,24,.542,99,36,79,.456,25,47,.532,11,32,.344,11,14,.786,94
42,2013-03-27,DEN,@,SAS,L 99-100,240,42,88,.477,42,78,.538,0,10,.000,15,17,.882,99,35,76,.461,25,61,.410,10,15,.667,20,27,.741,100
43,2013-03-29,TOR,@,DET,W 99-82,240,44,82,.537,40,69,.580,4,13,.308,7,9,.778,99,31,76,.408,26,58,.448,5,18,.278,15,23,.652,82
44,2013-03-30,MEM,@,MIN,W 99-86,240,37,73,.507,31,63,.492,6,10,.600,19,27,.704,99,29,67,.433,24,51,.471,5,16,.313,23,34,.676,86
45,2013-04-09,WAS,@,NYK,L 99-120,240,35,77,.455,27,57,.474,8,20,.400,21,30,.700,99,45,80,.563,25,44,.568,20,36,.556,10,14,.714,120
46,2013-04-17,DET,@,BRK,L 99-103,240,37,78,.474,36,65,.554,1,13,.077,24,32,.750,99,39,81,.481,31,57,.544,8,24,.333,17,23,.739,103
47,2013-04-17,GSW,@,POR,W 99-88,240,40,93,.430,31,72,.431,9,21,.429,10,13,.769,99,35,82,.427,29,70,.414,6,12,.500,12,14,.857,88
48,2012-11-03,SAC,@,IND,L 98-106,290,37,102,.363,29,80,.363,8,22,.364,16,20,.800,98,39,99,.394,35,77,.455,4,22,.182,24,27,.889,106
49,2012-11-15,MIA,@,DEN,W 98-93,240,36,77,.468,23,50,.460,13,27,.481,13,16,.813,98,37,88,.420,31,68,.456,6,20,.300,13,19,.684,93
50,2012-11-19,MIL,@,CHA,L 98-102,240,44,93,.473,42,77,.545,2,16,.125,8,11,.727,98,36,82,.439,33,71,.465,3,11,.273,27,30,.900,102
51,2012-11-20,TOR,@,PHI,L 98-106,240,37,82,.451,33,66,.500,4,16,.250,20,29,.690,98,40,85,.471,31,61,.508,9,24,.375,17,19,.895,106
52,2012-11-23,LAL,@,MEM,L 98-106,240,33,74,.446,21,47,.447,12,27,.444,20,24,.833,98,38,75,.507,32,64,.500,6,11,.545,24,30,.800,106
1,2012-11-27,DAL,@,PHI,L 98-100,240,37,81,.457,32,62,.516,5,19,.263,19,22,.864,98,35,75,.467,29,61,.475,6,14,.429,24,32,.750,100
2,2012-11-28,HOU,@,OKC,L 98-120,240,36,87,.414,28,66,.424,8,21,.381,18,30,.600,98,47,87,.540,38,65,.585,9,22,.409,17,22,.773,120
3,2012-11-30,BRK,@,ORL,W 98-86,240,38,83,.458,27,63,.429,11,20,.550,11,13,.846,98,35,78,.449,34,67,.507,1,11,.091,15,19,.789,86
4,2012-12-04,PHO,@,MEM,L 98-108,265,38,82,.463,32,68,.471,6,14,.429,16,22,.727,98,40,85,.471,36,66,.545,4,19,.211,24,31,.774,108
5,2012-12-09,ORL,@,PHO,W 98-90,240,40,77,.519,35,62,.565,5,15,.333,13,18,.722,98,36,78,.462,31,58,.534,5,20,.250,13,18,.722,90
6,2012-12-29,NOH,@,CHA,W 98-95,240,35,82,.427,24,58,.414,11,24,.458,17,23,.739,98,39,79,.494,35,69,.507,4,10,.400,13,20,.650,95
7,2013-01-11,SAS,@,MEM,L 98-101,265,35,76,.461,25,51,.490,10,25,.400,18,22,.818,98,40,85,.471,37,73,.507,3,12,.250,18,21,.857,101
8,2013-01-14,MIN,@,DAL,L 98-113,240,35,85,.412,29,65,.446,6,20,.300,22,29,.759,98,46,77,.597,40,64,.625,6,13,.462,15,16,.938,113
9,2013-01-17,MIL,@,PHO,W 98-94,240,39,92,.424,33,76,.434,6,16,.375,14,20,.700,98,34,89,.382,30,75,.400,4,14,.286,22,29,.759,94
10,2013-01-19,SAS,@,ATL,W 98-93,240,41,86,.477,33,62,.532,8,24,.333,8,11,.727,98,35,85,.412,27,64,.422,8,21,.381,15,22,.682,93
11,2013-01-19,CLE,@,UTA,L 98-109,240,34,83,.410,28,62,.452,6,21,.286,24,30,.800,98,45,90,.500,39,74,.527,6,16,.375,13,17,.765,109
12,2013-01-21,WAS,@,POR,W 98-95,240,39,84,.464,31,65,.477,8,19,.421,12,17,.706,98,37,81,.457,30,57,.526,7,24,.292,14,18,.778,95
13,2013-01-27,MIA,@,BOS,L 98-100,290,39,96,.406,34,73,.466,5,23,.217,15,20,.750,98,36,88,.409,31,68,.456,5,20,.250,23,27,.852,100
14,2013-02-01,NOH,@,DEN,L 98-113,240,38,72,.528,34,59,.576,4,13,.308,18,21,.857,98,44,84,.524,37,62,.597,7,22,.318,18,22,.818,113
15,2013-02-02,ORL,@,MIL,L 98-107,240,41,94,.436,36,75,.480,5,19,.263,11,22,.500,98,42,90,.467,33,66,.500,9,24,.375,14,20,.700,107
16,2013-02-03,LAL,@,DET,W 98-97,240,39,83,.470,33,63,.524,6,20,.300,14,22,.636,98,41,92,.446,36,78,.462,5,14,.357,10,15,.667,97
17,2013-02-06,GSW,@,OKC,L 98-119,240,38,93,.409,28,73,.384,10,20,.500,12,16,.750,98,48,95,.505,40,72,.556,8,23,.348,15,20,.750,119
18,2013-02-20,PHO,@,GSW,L 98-108,240,40,84,.476,31,67,.463,9,17,.529,9,14,.643,98,42,87,.483,32,67,.478,10,20,.500,14,17,.824,108
19,2013-02-22,NYK,@,TOR,L 98-100,240,35,75,.467,25,47,.532,10,28,.357,18,23,.783,98,35,80,.438,28,62,.452,7,18,.389,23,28,.821,100
20,2013-02-26,ORL,@,PHI,W 98-84,240,41,76,.539,36,63,.571,5,13,.385,11,16,.688,98,32,81,.395,25,60,.417,7,21,.333,13,18,.722,84
21,2013-03-01,DAL,@,BRK,W 98-90,240,39,78,.500,30,57,.526,9,21,.429,11,14,.786,98,36,78,.462,29,55,.527,7,23,.304,11,14,.786,90
22,2013-03-03,ATL,@,LAL,L 98-99,240,41,82,.500,33,60,.550,8,22,.364,8,15,.533,98,38,78,.487,28,57,.491,10,21,.476,13,18,.722,99
23,2013-03-06,TOR,@,PHO,W 98-71,240,37,77,.481,26,53,.491,11,24,.458,13,15,.867,98,28,74,.378,21,51,.412,7,23,.304,8,15,.533,71
24,2013-03-12,NOH,@,BRK,L 98-108,240,40,78,.513,35,62,.565,5,16,.313,13,15,.867,98,40,80,.500,35,64,.547,5,16,.313,23,31,.742,108
25,2013-03-13,MIA,@,PHI,W 98-94,240,35,75,.467,30,55,.545,5,20,.250,23,27,.852,98,40,85,.471,33,67,.493,7,18,.389,7,12,.583,94
26,2013-03-20,MIA,@,CLE,W 98-95,240,32,72,.444,20,43,.465,12,29,.414,22,30,.733,98,37,81,.457,30,60,.500,7,21,.333,14,17,.824,95
27,2013-03-21,MIN,@,SAC,L 98-101,240,41,98,.418,40,79,.506,1,19,.053,15,18,.833,98,40,75,.533,34,57,.596,6,18,.333,15,18,.833,101
28,2013-03-30,CHI,@,DAL,L 98-100,240,38,80,.475,26,59,.441,12,21,.571,10,18,.556,98,40,79,.506,34,61,.557,6,18,.333,14,18,.778,100
29,2013-03-30,POR,@,GSW,L 98-125,240,33,86,.384,25,63,.397,8,23,.348,24,29,.828,98,47,87,.540,38,67,.567,9,20,.450,22,27,.815,125
30,2013-04-09,PHO,@,HOU,L 98-101,240,38,86,.442,31,74,.419,7,12,.583,15,19,.789,98,37,86,.430,31,56,.554,6,30,.200,21,24,.875,101
31,2013-04-17,CLE,@,CHA,L 98-105,240,39,80,.488,31,57,.544,8,23,.348,12,18,.667,98,37,73,.507,29,53,.547,8,20,.400,23,30,.767,105
32,2013-04-17,PHO,@,DEN,L 98-118,240,40,104,.385,33,79,.418,7,25,.280,11,17,.647,98,49,93,.527,45,77,.584,4,16,.250,16,20,.800,118
33,2012-11-06,DET,@,DEN,L 97-109,240,35,78,.449,29,66,.439,6,12,.500,21,25,.840,97,41,92,.446,31,62,.500,10,30,.333,17,22,.773,109
34,2012-11-08,OKC,@,CHI,W 97-91,240,36,73,.493,31,60,.517,5,13,.385,20,21,.952,97,35,84,.417,30,69,.435,5,15,.333,16,18,.889,91
35,2012-11-09,SAS,@,SAC,W 97-86,240,35,72,.486,30,54,.556,5,18,.278,22,26,.846,97,32,91,.352,29,75,.387,3,16,.188,19,26,.731,86
36,2012-11-10,DAL,@,CHA,L 97-101,265,32,79,.405,23,60,.383,9,19,.474,24,30,.800,97,40,95,.421,37,75,.493,3,20,.150,18,28,.643,101
37,2012-11-15,BOS,@,BRK,L 97-102,240,35,75,.467,28,62,.452,7,13,.538,20,25,.800,97,36,85,.424,28,63,.444,8,22,.364,22,28,.786,102
38,2012-11-17,MIA,@,PHO,W 97-88,240,38,71,.535,30,52,.577,8,19,.421,13,19,.684,97,34,79,.430,29,61,.475,5,18,.278,15,21,.714,88
39,2012-11-19,DEN,@,MEM,W 97-92,240,36,81,.444,31,66,.470,5,15,.333,20,28,.714,97,36,78,.462,30,61,.492,6,17,.353,14,17,.824,92
40,2012-11-21,TOR,@,CHA,L 97-98,240,37,80,.463,28,57,.491,9,23,.391,14,20,.700,97,36,86,.419,33,67,.493,3,19,.158,23,28,.821,98
41,2012-11-21,LAL,@,SAC,L 97-113,240,29,65,.446,17,39,.436,12,26,.462,27,39,.692,97,44,81,.543,37,66,.561,7,15,.467,18,22,.818,113
42,2012-11-24,UTA,@,SAC,L 97-108,240,32,79,.405,21,54,.389,11,25,.440,22,30,.733,97,40,74,.541,34,58,.586,6,16,.375,22,32,.688,108
43,2012-11-27,MIN,@,SAC,W 97-89,240,38,83,.458,32,61,.525,6,22,.273,15,18,.833,97,37,84,.440,31,67,.463,6,17,.353,9,14,.643,89
44,2012-11-30,IND,@,SAC,W 97-92,240,37,85,.435,28,59,.475,9,26,.346,14,19,.737,97,32,75,.427,26,58,.448,6,17,.353,22,25,.880,92
45,2012-11-30,PHO,@,TOR,L 97-101,240,37,77,.481,31,61,.508,6,16,.375,17,19,.895,97,39,81,.481,31,67,.463,8,14,.571,15,22,.682,101
46,2012-12-06,DAL,@,PHO,W 97-94,240,37,78,.474,33,66,.500,4,12,.333,19,24,.792,97,34,85,.400,26,64,.406,8,21,.381,18,25,.720,94
47,2012-12-09,MIL,@,BRK,W 97-88,240,33,71,.465,26,55,.473,7,16,.438,24,30,.800,97,32,79,.405,25,54,.463,7,25,.280,17,23,.739,88
48,2012-12-10,DET,@,PHI,L 97-104,240,32,81,.395,27,63,.429,5,18,.278,28,33,.848,97,44,82,.537,40,71,.563,4,11,.364,12,23,.522,104
49,2012-12-12,GSW,@,MIA,W 97-95,240,38,82,.463,29,58,.500,9,24,.375,12,14,.857,97,38,80,.475,31,58,.534,7,22,.318,12,15,.800,95
50,2012-12-23,UTA,@,ORL,W 97-93,240,36,83,.434,29,65,.446,7,18,.389,18,25,.720,97,38,76,.500,29,56,.518,9,20,.450,8,15,.533,93
51,2012-12-25,OKC,@,MIA,L 97-103,240,30,71,.423,25,55,.455,5,16,.313,32,38,.842,97,38,80,.475,30,52,.577,8,28,.286,19,19,1.000,103
52,2012-12-26,NOH,@,ORL,W 97-94,240,38,76,.500,36,64,.563,2,12,.167,19,20,.950,97,36,79,.456,25,49,.510,11,30,.367,11,13,.846,94
1,2012-12-28,ORL,@,WAS,L 97-105,240,39,86,.453,29,58,.500,10,28,.357,9,11,.818,97,42,88,.477,36,68,.529,6,20,.300,15,17,.882,105
2,2013-01-01,SAC,@,DET,L 97-103,240,36,86,.419,27,60,.450,9,26,.346,16,21,.762,97,39,75,.520,31,55,.564,8,20,.400,17,22,.773,103
3,2013-01-02,SAC,@,CLE,W 97-94,240,38,88,.432,35,72,.486,3,16,.188,18,23,.783,97,34,87,.391,29,66,.439,5,21,.238,21,24,.875,94
4,2013-01-11,POR,@,GSW,L 97-103,240,35,92,.380,20,49,.408,15,43,.349,12,19,.632,97,41,86,.477,35,71,.493,6,15,.400,15,18,.833,103
5,2013-01-12,PHO,@,CHI,W 97-81,240,36,73,.493,30,59,.508,6,14,.429,19,25,.760,97,32,88,.364,30,77,.390,2,11,.182,15,21,.714,81
6,2013-01-14,MIA,@,UTA,L 97-104,240,39,72,.542,30,49,.612,9,23,.391,10,16,.625,97,36,76,.474,28,58,.483,8,18,.444,24,28,.857,104
7,2013-01-16,DEN,@,OKC,L 97-117,240,33,73,.452,31,58,.534,2,15,.133,29,37,.784,97,44,85,.518,35,66,.530,9,19,.474,20,26,.769,117
8,2013-01-19,SAC,@,CHA,W 97-93,240,37,81,.457,32,63,.508,5,18,.278,18,21,.857,97,31,72,.431,26,57,.456,5,15,.333,26,38,.684,93
9,2013-01-24,TOR,@,ORL,W 97-95,240,39,78,.500,35,62,.565,4,16,.250,15,19,.789,97,35,81,.432,27,63,.429,8,18,.444,17,20,.850,95
10,2013-01-30,ORL,@,NYK,L 97-113,240,38,77,.494,31,51,.608,7,26,.269,14,16,.875,97,47,82,.573,33,48,.688,14,34,.412,5,8,.625,113
11,2013-01-31,DAL,@,GSW,L 97-100,240,36,81,.444,28,56,.500,8,25,.320,17,24,.708,97,36,84,.429,29,64,.453,7,20,.350,21,25,.840,100
12,2013-02-10,LAL,@,MIA,L 97-107,240,35,70,.500,28,58,.483,7,12,.583,20,26,.769,97,44,80,.550,38,64,.594,6,16,.375,13,14,.929,107
13,2013-02-10,OKC,@,PHO,W 97-69,240,34,76,.447,25,59,.424,9,17,.529,20,27,.741,97,30,91,.330,26,77,.338,4,14,.286,5,5,1.000,69
14,2013-02-13,UTA,@,MIN,W 97-93,240,38,87,.437,36,76,.474,2,11,.182,19,25,.760,97,29,85,.341,24,63,.381,5,22,.227,30,38,.789,93
15,2013-02-20,BRK,@,MIL,W 97-94,240,34,85,.400,25,59,.424,9,26,.346,20,26,.769,97,35,75,.467,29,61,.475,6,14,.429,18,31,.581,94
16,2013-02-24,SAS,@,PHO,W 97-87,240,32,72,.444,27,55,.491,5,17,.294,28,35,.800,97,30,81,.370,27,72,.375,3,9,.333,24,33,.727,87
17,2013-02-26,GSW,@,IND,L 97-108,240,33,76,.434,21,55,.382,12,21,.571,19,24,.792,97,41,84,.488,35,63,.556,6,21,.286,20,27,.741,108
18,2013-03-02,GSW,@,PHI,L 97-104,240,36,86,.419,26,60,.433,10,26,.385,15,19,.789,97,44,85,.518,32,67,.478,12,18,.667,4,9,.444,104
19,2013-03-04,MIA,@,MIN,W 97-81,240,38,74,.514,33,53,.623,5,21,.238,16,19,.842,97,33,88,.375,28,68,.412,5,20,.250,10,15,.667,81
20,2013-03-10,DET,@,LAC,L 97-129,240,30,64,.469,19,41,.463,11,23,.478,26,42,.619,97,50,80,.625,36,52,.692,14,28,.500,15,25,.600,129
21,2013-03-11,BRK,@,PHI,L 97-106,240,40,81,.494,34,62,.548,6,19,.316,11,16,.688,97,40,76,.526,32,61,.525,8,15,.533,18,27,.667,106
22,2013-03-13,DET,@,GSW,L 97-105,240,40,89,.449,35,72,.486,5,17,.294,12,14,.857,97,41,72,.569,33,54,.611,8,18,.444,15,25,.600,105
23,2013-03-22,OKC,@,ORL,W 97-89,240,34,80,.425,29,59,.492,5,21,.238,24,33,.727,97,38,92,.413,33,76,.434,5,16,.313,8,10,.800,89
24,2013-03-22,UTA,@,SAS,L 97-104,265,41,96,.427,33,79,.418,8,17,.471,7,12,.583,97,39,84,.464,31,64,.484,8,20,.400,18,24,.750,104
25,2013-03-27,MIA,@,CHI,L 97-101,240,37,77,.481,30,57,.526,7,20,.350,16,23,.696,97,40,85,.471,32,63,.508,8,22,.364,13,18,.722,101
26,2013-03-29,PHI,@,CLE,W 97-87,240,42,86,.488,35,68,.515,7,18,.389,6,10,.600,97,37,86,.430,33,68,.485,4,18,.222,9,15,.600,87
27,2013-04-05,CLE,@,BOS,W 97-91,240,36,89,.404,33,76,.434,3,13,.231,22,26,.846,97,36,89,.404,30,67,.448,6,22,.273,13,22,.591,91
28,2013-04-05,OKC,@,IND,W 97-75,240,37,78,.474,33,66,.500,4,12,.333,19,23,.826,97,27,72,.375,25,51,.490,2,21,.095,19,24,.792,75
29,2013-04-06,ATL,@,SAS,L 97-99,240,35,83,.422,30,71,.423,5,12,.417,22,25,.880,97,36,80,.450,33,65,.508,3,15,.200,24,29,.828,99
30,2013-04-07,UTA,@,GSW,W 97-90,240,40,88,.455,29,63,.460,11,25,.440,6,7,.857,97,35,74,.473,28,57,.491,7,17,.412,13,18,.722,90
31,2013-04-12,PHI,@,WAS,W 97-86,240,40,93,.430,33,71,.465,7,22,.318,10,11,.909,97,36,87,.414,35,74,.473,1,13,.077,13,21,.619,86
32,2012-11-07,CLE,@,GSW,L 96-106,240,36,86,.419,25,54,.463,11,32,.344,13,21,.619,96,42,78,.538,37,60,.617,5,18,.278,17,23,.739,106
33,2012-11-10,BOS,@,MIL,W 96-92,240,32,72,.444,27,57,.474,5,15,.333,27,34,.794,96,35,88,.398,32,69,.464,3,19,.158,19,26,.731,92
34,2012-11-14,NOH,@,HOU,L 96-100,240,34,84,.405,26,60,.433,8,24,.333,20,21,.952,96,36,80,.450,26,51,.510,10,29,.345,18,22,.818,100
35,2012-11-19,IND,@,WAS,W 96-89,240,34,70,.486,31,51,.608,3,19,.158,25,29,.862,96,31,87,.356,27,70,.386,4,17,.235,23,31,.742,89
36,2012-11-28,UTA,@,NOH,W 96-84,240,31,63,.492,25,52,.481,6,11,.545,28,38,.737,96,31,73,.425,26,52,.500,5,21,.238,17,21,.810,84
37,2012-12-07,MEM,@,NOH,W 96-89,240,36,72,.500,28,55,.509,8,17,.471,16,22,.727,96,36,75,.480,28,59,.475,8,16,.500,9,12,.750,89
38,2012-12-10,SAC,@,DAL,L 96-119,240,37,84,.440,25,57,.439,12,27,.444,10,16,.625,96,48,87,.552,41,67,.612,7,20,.350,16,21,.762,119
39,2012-12-12,CHI,@,PHI,W 96-89,240,34,78,.436,30,67,.448,4,11,.364,24,26,.923,96,41,91,.451,39,77,.506,2,14,.143,5,11,.455,89
40,2012-12-12,SAS,@,UTA,L 96-99,240,37,87,.425,29,68,.426,8,19,.421,14,18,.778,96,41,84,.488,33,65,.508,8,19,.421,9,15,.600,99
41,2012-12-16,HOU,@,TOR,L 96-103,240,32,78,.410,25,55,.455,7,23,.304,25,32,.781,96,39,85,.459,31,55,.564,8,30,.267,17,20,.850,103
42,2012-12-18,NOH,@,GSW,L 96-103,240,35,75,.467,26,48,.542,9,27,.333,17,17,1.000,96,34,78,.436,28,60,.467,6,18,.333,29,34,.853,103
43,2012-12-22,MEM,@,HOU,L 96-121,240,42,79,.532,40,66,.606,2,13,.154,10,14,.714,96,44,82,.537,32,54,.593,12,28,.429,21,26,.808,121
44,2012-12-22,DET,@,WAS,W 96-87,240,36,88,.409,28,69,.406,8,19,.421,16,20,.800,96,29,77,.377,25,56,.446,4,21,.190,25,32,.781,87
45,2012-12-23,POR,@,SAC,L 96-108,240,37,85,.435,30,61,.492,7,24,.292,15,17,.882,96,45,81,.556,36,62,.581,9,19,.474,9,11,.818,108
46,2012-12-30,UTA,@,LAC,L 96-107,240,33,80,.413,28,67,.418,5,13,.385,25,34,.735,96,39,78,.500,31,60,.517,8,18,.444,21,29,.724,107
47,2012-12-30,BOS,@,SAC,L 96-118,240,36,86,.419,29,64,.453,7,22,.318,17,19,.895,96,44,82,.537,34,62,.548,10,20,.500,20,25,.800,118
48,2012-12-31,PHO,@,OKC,L 96-114,240,37,78,.474,29,54,.537,8,24,.333,14,17,.824,96,44,87,.506,39,72,.542,5,15,.333,21,24,.875,114
49,2013-01-02,CHI,@,ORL,W 96-94,240,36,77,.468,31,65,.477,5,12,.417,19,25,.760,96,37,78,.474,28,54,.519,9,24,.375,11,14,.786,94
50,2013-01-04,CHI,@,MIA,W 96-89,240,36,80,.450,31,66,.470,5,14,.357,19,24,.792,96,30,65,.462,25,45,.556,5,20,.250,24,31,.774,89
1,2013-01-21,MIN,@,ATL,L 96-104,240,36,74,.486,31,60,.517,5,14,.357,19,26,.731,96,41,71,.577,31,55,.564,10,16,.625,12,21,.571,104
2,2013-01-27,OKC,@,LAL,L 96-105,240,36,81,.444,32,65,.492,4,16,.250,20,26,.769,96,41,74,.554,34,57,.596,7,17,.412,16,29,.552,105
3,2013-01-28,SAC,@,WAS,W 96-94,240,36,82,.439,27,59,.458,9,23,.391,15,25,.600,96,37,77,.481,34,66,.515,3,11,.273,17,21,.810,94
4,2013-01-30,LAC,@,MIN,W 96-90,240,35,76,.461,32,67,.478,3,9,.333,23,36,.639,96,33,76,.434,28,57,.491,5,19,.263,19,27,.704,90
5,2013-02-05,PHO,@,MEM,W 96-90,240,37,73,.507,33,63,.524,4,10,.400,18,22,.818,96,36,82,.439,33,73,.452,3,9,.333,15,17,.882,90
6,2013-02-06,NYK,@,WAS,L 96-106,240,34,84,.405,25,56,.446,9,28,.321,19,23,.826,96,42,79,.532,31,59,.525,11,20,.550,11,14,.786,106
7,2013-02-07,CHI,@,DEN,L 96-128,240,38,91,.418,28,64,.438,10,27,.370,10,14,.714,96,50,86,.581,41,67,.612,9,19,.474,19,23,.826,128
8,2013-02-08,PHO,@,OKC,L 96-127,240,39,83,.470,32,65,.492,7,18,.389,11,15,.733,96,50,87,.575,36,66,.545,14,21,.667,13,18,.722,127
9,2013-02-13,SAS,@,CLE,W 96-95,240,38,84,.452,33,65,.508,5,19,.263,15,18,.833,96,40,97,.412,38,86,.442,2,11,.182,13,15,.867,95
10,2013-02-13,HOU,@,LAC,L 96-106,240,36,82,.439,31,58,.534,5,24,.208,19,22,.864,96,37,75,.493,24,43,.558,13,32,.406,19,26,.731,106
11,2013-02-19,CHI,@,NOH,W 96-87,240,39,84,.464,34,71,.479,5,13,.385,13,17,.765,96,35,84,.417,31,67,.463,4,17,.235,13,20,.650,87
12,2013-02-19,TOR,@,WAS,W 96-88,240,35,78,.449,27,58,.466,8,20,.400,18,20,.900,96,30,78,.385,24,63,.381,6,15,.400,22,27,.815,88
13,2013-02-20,ORL,@,DAL,L 96-111,240,39,85,.459,34,69,.493,5,16,.313,13,22,.591,96,42,88,.477,31,59,.525,11,29,.379,16,18,.889,111
14,2013-02-27,DET,@,WAS,W 96-95,240,39,72,.542,30,57,.526,9,15,.600,9,16,.563,96,40,84,.476,32,65,.492,8,19,.421,7,10,.700,95
15,2013-03-01,NYK,@,WAS,W 96-88,240,35,81,.432,27,53,.509,8,28,.286,18,21,.857,96,31,74,.419,24,58,.414,7,16,.438,19,29,.655,88
16,2013-03-06,PHI,@,ATL,L 96-107,240,37,86,.430,31,69,.449,6,17,.353,16,21,.762,96,43,80,.538,32,56,.571,11,24,.458,10,17,.588,107
17,2013-03-06,ORL,@,MIA,L 96-97,240,40,89,.449,34,61,.557,6,28,.214,10,12,.833,96,32,74,.432,26,46,.565,6,28,.214,27,31,.871,97
18,2013-03-10,POR,@,NOH,L 96-98,240,37,76,.487,26,51,.510,11,25,.440,11,12,.917,96,40,86,.465,29,66,.439,11,20,.550,7,9,.778,98
19,2013-03-10,CLE,@,TOR,L 96-100,240,36,86,.419,29,65,.446,7,21,.333,17,27,.630,96,33,84,.393,25,61,.410,8,23,.348,26,34,.765,100
20,2013-03-13,MEM,@,LAC,W 96-85,240,37,68,.544,31,56,.554,6,12,.500,16,21,.762,96,31,72,.431,25,46,.543,6,26,.231,17,18,.944,85
21,2013-04-06,CHA,@,BRK,L 96-105,240,36,80,.450,29,59,.492,7,21,.333,17,23,.739,96,39,80,.488,34,59,.576,5,21,.238,22,30,.733,105
22,2013-04-07,WAS,@,BOS,L 96-107,240,39,88,.443,29,62,.468,10,26,.385,8,12,.667,96,43,77,.558,39,66,.591,4,11,.364,17,21,.810,107
23,2013-04-07,DAL,@,POR,W 96-91,240,42,90,.467,39,77,.506,3,13,.231,9,12,.750,96,37,80,.463,33,58,.569,4,22,.182,13,16,.813,91
24,2013-04-09,NOH,@,LAL,L 96-104,240,37,84,.440,32,64,.500,5,20,.250,17,18,.944,96,40,79,.506,33,54,.611,7,25,.280,17,22,.773,104
25,2013-04-12,LAC,@,NOH,W 96-93,240,35,78,.449,28,52,.538,7,26,.269,19,28,.679,96,35,83,.422,29,64,.453,6,19,.316,17,32,.531,93
26,2013-04-15,MIA,@,CLE,W 96-95,240,33,66,.500,20,38,.526,13,28,.464,17,27,.630,96,39,86,.453,34,73,.466,5,13,.385,12,19,.632,95
27,2013-04-15,UTA,@,MIN,W 96-80,240,36,77,.468,33,67,.493,3,10,.300,21,23,.913,96,32,75,.427,30,58,.517,2,17,.118,14,18,.778,80
28,2012-11-03,POR,@,HOU,W 95-85,265,39,93,.419,29,69,.420,10,24,.417,7,12,.583,95,34,96,.354,29,70,.414,5,26,.192,12,18,.667,85
29,2012-11-09,MIA,@,ATL,W 95-89,240,37,76,.487,30,54,.556,7,22,.318,14,16,.875,95,34,81,.420,25,56,.446,9,25,.360,12,16,.750,89
30,2012-11-12,ATL,@,POR,W 95-87,240,35,79,.443,28,61,.459,7,18,.389,18,22,.818,95,30,83,.361,24,60,.400,6,23,.261,21,26,.808,87
31,2012-11-16,NYK,@,MEM,L 95-105,240,37,72,.514,32,53,.604,5,19,.263,16,21,.762,95,37,76,.487,32,61,.525,5,15,.333,26,32,.813,105
32,2012-11-23,MIN,@,POR,L 95-103,240,32,78,.410,29,60,.483,3,18,.167,28,37,.757,95,42,78,.538,31,53,.585,11,25,.440,8,18,.444,103
33,2012-11-28,BRK,@,BOS,W 95-83,240,33,82,.402,23,58,.397,10,24,.417,19,29,.655,95,32,75,.427,31,68,.456,1,7,.143,18,24,.750,83
34,2012-11-28,MIN,@,LAC,L 95-101,240,31,82,.378,25,60,.417,6,22,.273,27,35,.771,95,37,81,.457,33,62,.532,4,19,.211,23,26,.885,101
35,2012-12-01,MEM,@,SAS,L 95-99,265,36,99,.364,32,84,.381,4,15,.267,19,22,.864,95,37,89,.416,30,60,.500,7,29,.241,18,24,.750,99
36,2012-12-05,CHI,@,CLE,W 95-85,240,34,72,.472,30,57,.526,4,15,.267,23,27,.852,95,31,85,.365,26,69,.377,5,16,.313,18,25,.720,85
37,2012-12-07,WAS,@,ATL,L 95-104,240,36,79,.456,29,63,.460,7,16,.438,16,20,.800,95,41,85,.482,31,59,.525,10,26,.385,12,19,.632,104
38,2013-01-01,ATL,@,NOH,W 95-86,240,41,83,.494,32,61,.525,9,22,.409,4,8,.500,95,36,82,.439,26,62,.419,10,20,.500,4,12,.333,86
39,2013-01-11,UTA,@,ATL,L 95-103,240,36,76,.474,28,56,.500,8,20,.400,15,19,.789,95,40,72,.556,31,53,.585,9,19,.474,14,23,.609,103
40,2013-01-16,BRK,@,ATL,L 95-109,240,37,87,.425,33,61,.541,4,26,.154,17,17,1.000,95,45,78,.577,37,57,.649,8,21,.381,11,17,.647,109
41,2013-01-18,HOU,@,IND,L 95-105,240,34,83,.410,21,53,.396,13,30,.433,14,16,.875,95,40,87,.460,29,68,.426,11,19,.579,14,17,.824,105
42,2013-01-27,PHO,@,DAL,L 95-110,240,34,77,.442,30,60,.500,4,17,.235,23,28,.821,95,45,88,.511,40,77,.519,5,11,.455,15,18,.833,110
43,2013-02-02,CHA,@,HOU,L 95-109,240,33,79,.418,25,60,.417,8,19,.421,21,24,.875,95,42,82,.512,35,62,.565,7,20,.350,18,23,.783,109
44,2013-02-06,CHA,@,CLE,L 95-122,240,37,79,.468,31,64,.484,6,15,.400,15,25,.600,95,52,92,.565,43,68,.632,9,24,.375,9,13,.692,122
45,2013-02-07,LAL,@,BOS,L 95-116,240,36,87,.414,31,64,.484,5,23,.217,18,30,.600,95,46,87,.529,41,76,.539,5,11,.455,19,25,.760,116
46,2013-02-24,SAC,@,NOH,L 95-110,240,35,83,.422,23,64,.359,12,19,.632,13,13,1.000,95,45,89,.506,39,73,.534,6,16,.375,14,15,.933,110
47,2013-02-26,MIL,@,DAL,W 95-90,240,34,82,.415,27,64,.422,7,18,.389,20,26,.769,95,36,85,.424,35,68,.515,1,17,.059,17,21,.810,90
48,2013-03-01,DET,@,NOH,L 95-100,240,39,78,.500,32,59,.542,7,19,.368,10,16,.625,95,35,81,.432,28,61,.459,7,20,.350,23,31,.742,100
49,2013-03-07,OKC,@,NYK,W 95-94,240,31,70,.443,23,49,.469,8,21,.381,25,29,.862,95,35,86,.407,25,55,.455,10,31,.323,14,14,1.000,94
1,2013-03-17,NOH,@,MIN,L 95-97,240,39,85,.459,34,72,.472,5,13,.385,12,16,.750,95,36,64,.563,31,49,.633,5,15,.333,20,27,.741,97
2,2013-03-19,POR,@,MIL,L 95-102,240,36,83,.434,23,57,.404,13,26,.500,10,13,.769,95,42,87,.483,33,68,.485,9,19,.474,9,13,.692,102
3,2013-03-23,SAC,@,DEN,L 95-101,240,39,86,.453,31,58,.534,8,28,.286,9,17,.529,95,37,85,.435,33,71,.465,4,14,.286,23,32,.719,101
4,2013-03-23,BRK,@,LAC,L 95-101,240,34,74,.459,25,49,.510,9,25,.360,18,24,.750,95,37,79,.468,28,53,.528,9,26,.346,18,24,.750,101
5,2013-03-24,SAS,@,HOU,L 95-96,240,33,78,.423,23,56,.411,10,22,.455,19,21,.905,95,32,80,.400,23,54,.426,9,26,.346,23,27,.852,96
6,2013-04-03,NYK,@,ATL,W 95-82,240,40,77,.519,33,55,.600,7,22,.318,8,12,.667,95,32,66,.485,23,40,.575,9,26,.346,9,19,.474,82
7,2013-04-05,TOR,@,MIN,W 95-93,240,40,85,.471,36,70,.514,4,15,.267,11,16,.688,95,30,67,.448,27,52,.519,3,15,.200,30,40,.750,93
8,2013-04-07,LAL,@,LAC,L 95-109,240,33,76,.434,26,52,.500,7,24,.292,22,30,.733,95,42,84,.500,34,63,.540,8,21,.381,17,21,.810,109
9,2013-04-07,NOH,@,PHO,W 95-92,240,32,80,.400,28,65,.431,4,15,.267,27,29,.931,95,34,80,.425,27,59,.458,7,21,.333,17,19,.895,92
10,2013-04-10,MIN,@,LAC,L 95-111,240,35,90,.389,29,67,.433,6,23,.261,19,22,.864,95,44,77,.571,33,56,.589,11,21,.524,12,16,.750,111
11,2013-04-15,NYK,@,CHA,L 95-106,240,34,79,.430,20,42,.476,14,37,.378,13,13,1.000,95,43,74,.581,36,56,.643,7,18,.389,13,14,.929,106
12,2013-04-15,SAC,@,OKC,L 95-104,240,38,87,.437,31,60,.517,7,27,.259,12,21,.571,95,42,92,.457,37,69,.536,5,23,.217,15,20,.750,104
13,2013-04-17,HOU,@,LAL,L 95-99,265,35,84,.417,27,51,.529,8,33,.242,17,24,.708,95,33,90,.367,23,58,.397,10,32,.313,23,34,.676,99
14,2013-04-17,MIL,@,OKC,W 95-89,240,36,85,.424,26,58,.448,10,27,.370,13,18,.722,95,37,89,.416,34,68,.500,3,21,.143,12,14,.857,89
15,2012-10-31,DAL,@,UTA,L 94-113,240,32,85,.376,21,63,.333,11,22,.500,19,26,.731,94,38,89,.427,32,75,.427,6,14,.429,31,42,.738,113
16,2012-11-04,PHO,@,ORL,L 94-115,240,39,91,.429,34,72,.472,5,19,.263,11,18,.611,94,45,92,.489,36,81,.444,9,11,.818,16,19,.842,115
17,2012-11-05,UTA,@,MEM,L 94-103,240,40,90,.444,35,75,.467,5,15,.333,9,13,.692,94,38,91,.418,33,77,.429,5,14,.357,22,25,.880,103
18,2012-11-07,WAS,@,BOS,L 94-100,265,39,95,.411,29,66,.439,10,29,.345,6,7,.857,94,34,81,.420,30,68,.441,4,13,.308,28,34,.824,100
19,2012-11-09,IND,@,MIN,L 94-96,240,37,84,.440,32,66,.485,5,18,.278,15,17,.882,94,35,70,.500,33,61,.541,2,9,.222,24,28,.857,96
20,2012-11-09,DAL,@,NYK,L 94-104,240,33,81,.407,25,53,.472,8,28,.286,20,23,.870,94,35,84,.417,27,62,.435,8,22,.364,26,38,.684,104
21,2012-11-09,DET,@,OKC,L 94-105,240,36,87,.414,30,68,.441,6,19,.316,16,22,.727,94,38,71,.535,30,51,.588,8,20,.400,21,26,.808,105
22,2012-11-14,DET,@,PHI,W 94-76,240,35,73,.479,32,66,.485,3,7,.429,21,31,.677,94,25,84,.298,20,68,.294,5,16,.313,21,32,.656,76
23,2012-11-17,MEM,@,CHA,W 94-87,240,31,80,.388,29,66,.439,2,14,.143,30,34,.882,94,32,85,.376,28,72,.389,4,13,.308,19,28,.679,87
24,2012-11-18,CHI,@,POR,L 94-102,240,37,75,.493,33,59,.559,4,16,.250,16,18,.889,94,39,79,.494,30,57,.526,9,22,.409,15,20,.750,102
25,2012-11-30,UTA,@,OKC,L 94-106,240,38,92,.413,31,69,.449,7,23,.304,11,12,.917,94,39,75,.520,35,66,.530,4,9,.444,24,33,.727,106
26,2012-12-05,MIN,@,BOS,L 94-104,240,37,84,.440,31,65,.477,6,19,.316,14,30,.467,94,41,78,.526,37,61,.607,4,17,.235,18,26,.692,104
27,2012-12-07,BOS,@,PHI,L 94-95,265,35,81,.432,29,59,.492,6,22,.273,18,25,.720,94,37,99,.374,35,88,.398,2,11,.182,19,26,.731,95
28,2012-12-11,LAC,@,CHI,W 94-89,240,37,80,.463,33,69,.478,4,11,.364,16,23,.696,94,35,87,.402,25,67,.373,10,20,.500,9,12,.750,89
29,2012-12-11,LAL,@,CLE,L 94-100,240,31,75,.413,24,48,.500,7,27,.259,25,40,.625,94,37,84,.440,26,57,.456,11,27,.407,15,26,.577,100
30,2012-12-12,BRK,@,TOR,W 94-88,240,29,64,.453,19,45,.422,10,19,.526,26,35,.743,94,37,75,.493,33,57,.579,4,18,.222,10,17,.588,88
31,2012-12-14,MEM,@,DEN,L 94-99,240,39,94,.415,32,75,.427,7,19,.368,9,10,.900,94,36,69,.522,32,59,.542,4,10,.400,23,26,.885,99
32,2012-12-16,NOH,@,POR,L 94-95,240,36,80,.450,25,60,.417,11,20,.550,11,15,.733,94,37,80,.463,26,51,.510,11,29,.379,10,12,.833,95
33,2012-12-21,NOH,@,SAS,L 94-99,240,39,86,.453,37,70,.529,2,16,.125,14,16,.875,94,39,76,.513,35,58,.603,4,18,.222,17,23,.739,99
34,2012-12-22,CLE,@,MIL,W 94-82,240,38,88,.432,33,71,.465,5,17,.294,13,16,.813,94,31,79,.392,27,59,.458,4,20,.200,16,23,.696,82
35,2012-12-25,NYK,@,LAL,L 94-100,240,38,89,.427,29,63,.460,9,26,.346,9,16,.563,94,37,77,.481,32,56,.571,5,21,.238,21,31,.677,100
36,2012-12-26,GSW,@,UTA,W 94-83,240,33,82,.402,24,64,.375,9,18,.500,19,20,.950,94,32,83,.386,28,66,.424,4,17,.235,15,22,.682,83
37,2012-12-30,MIL,@,DET,L 94-96,240,36,77,.468,26,54,.481,10,23,.435,12,17,.706,94,39,82,.476,33,64,.516,6,18,.333,12,15,.800,96
38,2013-01-02,LAC,@,GSW,L 94-115,240,29,80,.363,21,51,.412,8,29,.276,28,39,.718,94,42,84,.500,30,61,.492,12,23,.522,19,22,.864,115
39,2013-01-07,DAL,@,UTA,L 94-100,240,35,81,.432,29,62,.468,6,19,.316,18,20,.900,94,31,78,.397,21,59,.356,10,19,.526,28,36,.778,100
40,2013-01-09,MEM,@,GSW,W 94-87,240,40,88,.455,38,71,.535,2,17,.118,12,16,.750,94,33,71,.465,26,54,.481,7,17,.412,14,20,.700,87
41,2013-01-16,WAS,@,SAC,L 94-95,240,39,86,.453,31,69,.449,8,17,.471,8,11,.727,94,41,85,.482,36,74,.486,5,11,.455,8,13,.615,95
42,2013-02-04,CHA,@,MIA,L 94-99,240,34,80,.425,26,55,.473,8,25,.320,18,20,.900,94,41,81,.506,40,69,.580,1,12,.083,16,24,.667,99
43,2013-02-12,OKC,@,UTA,L 94-109,240,38,68,.559,33,53,.623,5,15,.333,13,23,.565,94,42,87,.483,35,68,.515,7,19,.368,18,22,.818,109
44,2013-02-23,UTA,@,LAC,L 94-107,240,35,84,.417,34,69,.493,1,15,.067,23,28,.821,94,40,78,.513,32,58,.552,8,20,.400,19,24,.792,107
45,2013-02-28,MIN,@,LAL,L 94-116,240,37,81,.457,30,60,.500,7,21,.333,13,15,.867,94,44,83,.530,28,51,.549,16,32,.500,12,21,.571,116
46,2013-03-02,MIN,@,POR,L 94-109,240,34,87,.391,33,75,.440,1,12,.083,25,36,.694,94,44,90,.489,37,70,.529,7,20,.350,14,22,.636,109
47,2013-03-08,HOU,@,GSW,W 94-88,240,27,74,.365,12,39,.308,15,35,.429,25,34,.735,94,33,87,.379,24,66,.364,9,21,.429,13,20,.650,88
48,2013-03-13,NYK,@,DEN,L 94-117,240,34,79,.430,23,51,.451,11,28,.393,15,22,.682,94,41,84,.488,32,63,.508,9,21,.429,26,37,.703,117
49,2013-03-15,PHO,@,ATL,L 94-107,240,35,79,.443,32,60,.533,3,19,.158,21,31,.677,94,41,84,.488,29,61,.475,12,23,.522,13,16,.813,107
50,2013-03-20,ORL,@,NYK,L 94-106,240,38,79,.481,33,62,.532,5,17,.294,13,18,.722,94,40,76,.526,25,42,.595,15,34,.441,11,16,.688,106
51,2013-03-22,BOS,@,DAL,L 94-104,240,32,77,.416,27,60,.450,5,17,.294,25,27,.926,94,38,82,.463,32,63,.508,6,19,.316,22,28,.786,104
1,2013-03-25,ATL,@,IND,L 94-100,240,36,80,.450,29,59,.492,7,21,.333,15,25,.600,94,40,84,.476,32,61,.525,8,23,.348,12,15,.800,100
2,2013-03-25,MEM,@,WAS,L 94-107,240,34,77,.442,28,61,.459,6,16,.375,20,22,.909,94,36,72,.500,31,59,.525,5,13,.385,30,44,.682,107
3,2013-03-29,HOU,@,MEM,L 94-103,240,34,81,.420,25,54,.463,9,27,.333,17,21,.810,94,40,79,.506,36,68,.529,4,11,.364,19,21,.905,103
4,2013-03-31,DET,@,CHI,L 94-95,240,36,72,.500,29,56,.518,7,16,.438,15,22,.682,94,30,76,.395,22,53,.415,8,23,.348,27,40,.675,95
5,2013-04-01,CLE,@,ATL,L 94-102,240,41,81,.506,38,69,.551,3,12,.250,9,15,.600,94,37,81,.457,28,51,.549,9,30,.300,19,26,.731,102
6,2013-04-03,MEM,@,POR,W 94-76,240,34,67,.507,30,55,.545,4,12,.333,22,28,.786,94,33,80,.413,29,51,.569,4,29,.138,6,10,.600,76
7,2013-04-04,DAL,@,DEN,L 94-95,240,41,88,.466,37,70,.529,4,18,.222,8,10,.800,94,35,89,.393,29,72,.403,6,17,.353,19,30,.633,95
8,2013-04-09,CLE,@,IND,L 94-99,240,39,85,.459,36,75,.480,3,10,.300,13,15,.867,94,32,79,.405,28,63,.444,4,16,.250,31,46,.674,99
9,2012-11-06,ORL,@,CHI,L 93-99,240,36,86,.419,28,67,.418,8,19,.421,13,17,.765,93,40,84,.476,38,78,.487,2,6,.333,17,24,.708,99
10,2012-11-07,DEN,@,HOU,W 93-87,240,37,82,.451,30,64,.469,7,18,.389,12,21,.571,93,31,84,.369,23,51,.451,8,33,.242,17,23,.739,87
11,2012-11-10,PHI,@,TOR,W 93-83,240,34,73,.466,28,59,.475,6,14,.429,19,25,.760,93,30,79,.380,18,53,.340,12,26,.462,11,16,.688,83
12,2012-11-14,UTA,@,BOS,L 93-98,240,33,82,.402,26,67,.388,7,15,.467,20,28,.714,93,36,72,.500,32,62,.516,4,10,.400,22,29,.759,98
13,2012-11-16,UTA,@,PHI,L 93-99,240,36,81,.444,29,59,.492,7,22,.318,14,18,.778,93,40,87,.460,30,69,.435,10,18,.556,9,10,.900,99
14,2012-11-21,BRK,@,GSW,L 93-102,240,38,83,.458,32,60,.533,6,23,.261,11,15,.733,93,40,75,.533,33,60,.550,7,15,.467,15,19,.789,102
15,2012-11-24,LAC,@,ATL,L 93-104,240,32,75,.427,24,56,.429,8,19,.421,21,25,.840,93,38,75,.507,31,58,.534,7,17,.412,21,26,.808,104
16,2012-11-24,CHI,@,MIL,W 93-86,240,32,82,.390,28,66,.424,4,16,.250,25,26,.962,93,38,88,.432,35,71,.493,3,17,.176,7,10,.700,86
17,2012-11-26,MIL,@,CHI,W 93-92,240,39,85,.459,36,70,.514,3,15,.200,12,19,.632,93,35,80,.438,30,69,.435,5,11,.455,17,19,.895,92
18,2012-12-07,CHA,@,MIL,L 93-108,240,36,81,.444,33,68,.485,3,13,.231,18,32,.563,93,38,94,.404,32,80,.400,6,14,.429,26,32,.813,108
19,2012-12-08,ATL,@,MEM,W 93-83,240,34,77,.442,27,60,.450,7,17,.412,18,25,.720,93,33,77,.429,27,61,.443,6,16,.375,11,18,.611,83
20,2012-12-09,IND,@,OKC,L 93-104,240,38,82,.463,32,65,.492,6,17,.353,11,13,.846,93,37,76,.487,32,57,.561,5,19,.263,25,30,.833,104
21,2012-12-12,WAS,@,HOU,L 93-99,240,35,89,.393,28,64,.438,7,25,.280,16,20,.800,93,34,76,.447,25,52,.481,9,24,.375,22,30,.733,99
22,2012-12-17,SAS,@,OKC,L 93-107,240,36,79,.456,30,59,.508,6,20,.300,15,21,.714,93,38,85,.447,34,71,.479,4,14,.286,27,30,.900,107
23,2012-12-17,MIN,@,ORL,L 93-102,240,39,96,.406,32,71,.451,7,25,.280,8,12,.667,93,44,82,.537,38,68,.559,6,14,.429,8,8,1.000,102
24,2012-12-18,IND,@,MIL,L 93-98,240,32,80,.400,30,72,.417,2,8,.250,27,34,.794,93,37,86,.430,31,72,.431,6,14,.429,18,26,.692,98
25,2012-12-20,OKC,@,MIN,L 93-99,240,33,82,.402,28,62,.452,5,20,.250,22,26,.846,93,37,84,.440,28,64,.438,9,20,.450,16,23,.696,99
26,2012-12-20,DEN,@,POR,L 93-101,240,38,98,.388,38,76,.500,0,22,.000,17,24,.708,93,33,92,.359,19,56,.339,14,36,.389,21,26,.808,101
27,2012-12-22,PHO,@,POR,L 93-96,240,40,89,.449,35,70,.500,5,19,.263,8,11,.727,93,33,69,.478,26,49,.531,7,20,.350,23,28,.821,96
28,2012-12-25,BOS,@,BRK,W 93-76,240,38,77,.494,32,67,.478,6,10,.600,11,13,.846,93,26,64,.406,19,44,.432,7,20,.350,17,29,.586,76
29,2012-12-26,BRK,@,MIL,L 93-108,240,34,88,.386,30,67,.448,4,21,.190,21,24,.875,93,40,84,.476,30,67,.448,10,17,.588,18,19,.947,108
30,2013-01-02,MEM,@,BOS,W 93-83,240,34,71,.479,26,53,.491,8,18,.444,17,22,.773,93,32,71,.451,24,49,.490,8,22,.364,11,16,.688,83
31,2013-01-05,SAC,@,BRK,L 93-113,240,36,90,.400,30,71,.423,6,19,.316,15,23,.652,93,44,85,.518,37,61,.607,7,24,.292,18,21,.857,113
32,2013-01-09,DAL,@,LAC,L 93-99,240,36,84,.429,30,66,.455,6,18,.333,15,18,.833,93,38,79,.481,28,55,.509,10,24,.417,13,21,.619,99
33,2013-01-13,CLE,@,LAL,L 93-113,240,39,95,.411,35,74,.473,4,21,.190,11,12,.917,93,40,69,.580,27,44,.614,13,25,.520,20,27,.741,113
34,2013-01-16,CLE,@,POR,W 93-88,240,32,83,.386,28,66,.424,4,17,.235,25,32,.781,93,31,79,.392,22,50,.440,9,29,.310,17,26,.654,88
35,2013-01-23,LAL,@,MEM,L 93-106,240,31,73,.425,24,56,.429,7,17,.412,24,32,.750,93,47,96,.490,43,83,.518,4,13,.308,8,10,.800,106
36,2013-01-26,SAC,@,DEN,L 93-121,240,37,88,.420,29,66,.439,8,22,.364,11,22,.500,93,47,89,.528,34,58,.586,13,31,.419,14,17,.824,121
37,2013-02-02,CHI,@,ATL,W 93-76,240,38,93,.409,30,73,.411,8,20,.400,9,13,.692,93,31,79,.392,25,60,.417,6,19,.316,8,15,.533,76
38,2013-02-02,PHO,@,GSW,L 93-113,240,35,86,.407,30,71,.423,5,15,.333,18,24,.750,93,45,89,.506,36,70,.514,9,19,.474,14,20,.700,113
39,2013-02-06,BRK,@,DET,W 93-90,240,34,82,.415,28,66,.424,6,16,.375,19,25,.760,93,36,83,.434,33,66,.500,3,17,.176,15,21,.714,90
40,2013-02-08,GSW,@,MEM,L 93-99,240,36,74,.486,30,57,.526,6,17,.353,15,20,.750,93,36,79,.456,28,59,.475,8,20,.400,19,23,.826,99
41,2013-02-08,CHI,@,UTA,W 93-89,240,36,79,.456,31,67,.463,5,12,.417,16,18,.889,93,37,78,.474,33,62,.532,4,16,.250,11,17,.647,89
42,2013-02-24,PHI,@,NYK,L 93-99,240,36,85,.424,32,72,.444,4,13,.308,17,20,.850,93,32,75,.427,24,42,.571,8,33,.242,27,35,.771,99
43,2013-03-01,IND,@,TOR,W 93-81,240,34,70,.486,27,50,.540,7,20,.350,18,22,.818,93,29,72,.403,26,61,.426,3,11,.273,20,25,.800,81
44,2013-03-08,PHI,@,MIA,L 93-102,240,37,77,.481,27,56,.482,10,21,.476,9,11,.818,93,42,79,.532,34,58,.586,8,21,.381,10,13,.769,102
45,2013-03-09,BRK,@,ATL,W 93-80,240,36,83,.434,30,60,.500,6,23,.261,15,22,.682,93,32,77,.416,27,59,.458,5,18,.278,11,16,.688,80
46,2013-03-11,OKC,@,SAS,L 93-105,240,33,77,.429,27,60,.450,6,17,.353,21,24,.875,93,43,82,.524,35,61,.574,8,21,.381,11,14,.786,105
47,2013-03-13,MIL,@,WAS,L 93-106,240,39,85,.459,33,67,.493,6,18,.333,9,12,.750,93,43,86,.500,35,70,.500,8,16,.500,12,24,.500,106
48,2013-03-18,GSW,@,NOH,W 93-72,240,35,70,.500,25,51,.490,10,19,.526,13,15,.867,93,28,83,.337,25,66,.379,3,17,.176,13,13,1.000,72
49,2013-03-20,UTA,@,HOU,L 93-100,240,36,79,.456,31,62,.500,5,17,.294,16,20,.800,93,34,76,.447,28,53,.528,6,23,.261,26,32,.813,100
50,2013-03-20,GSW,@,SAS,L 93-104,240,37,84,.440,31,72,.431,6,12,.500,13,15,.867,93,41,85,.482,33,59,.559,8,26,.308,14,15,.933,104
51,2013-03-27,BOS,@,CLE,W 93-92,240,34,76,.447,29,62,.468,5,14,.357,20,28,.714,93,38,86,.442,31,69,.449,7,17,.412,9,14,.643,92
52,2013-03-29,OKC,@,MIN,L 93-101,240,36,79,.456,31,63,.492,5,16,.313,16,20,.800,93,37,83,.446,32,68,.471,5,15,.333,22,27,.815,101
53,2013-04-03,DET,@,BOS,L 93-98,240,34,93,.366,30,69,.435,4,24,.167,21,30,.700,93,36,71,.507,29,51,.569,7,20,.350,19,22,.864,98
54,2013-04-12,CHA,@,DET,L 93-113,240,35,78,.449,26,54,.481,9,24,.375,14,17,.824,93,43,83,.518,31,65,.477,12,18,.667,15,20,.750,113
55,2013-04-13,PHO,@,MIN,L 93-105,240,37,73,.507,28,53,.528,9,20,.450,10,14,.714,93,41,83,.494,35,68,.515,6,15,.400,17,19,.895,105
56,2013-04-14,CHI,@,MIA,L 93-105,240,29,82,.354,18,56,.321,11,26,.423,24,31,.774,93,36,70,.514,30,53,.566,6,17,.353,27,41,.659,105
57,2013-04-17,ORL,@,MIA,L 93-105,240,40,77,.519,38,63,.603,2,14,.143,11,25,.440,93,42,78,.538,30,49,.612,12,29,.414,9,19,.474,105
58,2012-10-31,MEM,@,LAC,L 92-101,240,33,86,.384,31,72,.431,2,14,.143,24,30,.800,92,38,74,.514,33,59,.559,5,15,.333,20,29,.690,101
59,2012-11-02,POR,@,OKC,L 92-106,240,32,89,.360,23,63,.365,9,26,.346,19,24,.792,92,39,76,.513,34,67,.507,5,9,.556,23,32,.719,106
1,2012-11-05,GSW,@,SAC,L 92-94,240,31,78,.397,25,57,.439,6,21,.286,24,28,.857,92,37,81,.457,33,62,.532,4,19,.211,16,23,.696,94
2,2012-11-12,OKC,@,DET,W 92-90,240,27,73,.370,26,63,.413,1,10,.100,37,42,.881,92,33,83,.398,27,66,.409,6,17,.353,18,27,.667,90
3,2012-11-19,LAC,@,SAS,W 92-87,240,40,85,.471,39,73,.534,1,12,.083,11,19,.579,92,29,82,.354,23,62,.371,6,20,.300,23,28,.821,87
4,2012-12-01,IND,@,GSW,L 92-103,240,34,74,.459,26,52,.500,8,22,.364,16,20,.800,92,38,80,.475,29,60,.483,9,20,.450,18,19,.947,103
5,2012-12-05,POR,@,IND,L 92-99,240,34,79,.430,28,57,.491,6,22,.273,18,22,.818,92,36,80,.450,27,54,.500,9,26,.346,18,19,.947,99
6,2012-12-07,DEN,@,IND,W 92-89,240,38,86,.442,35,69,.507,3,17,.176,13,20,.650,92,34,76,.447,24,53,.453,10,23,.435,11,18,.611,89
7,2012-12-07,HOU,@,SAS,L 92-114,240,37,95,.389,26,62,.419,11,33,.333,7,8,.875,92,48,87,.552,42,67,.627,6,20,.300,12,13,.923,114
8,2012-12-10,ATL,@,MIA,L 92-101,240,32,75,.427,23,47,.489,9,28,.321,19,20,.950,92,39,67,.582,30,46,.652,9,21,.429,14,22,.636,101
9,2012-12-18,UTA,@,BRK,W 92-90,240,37,83,.446,32,63,.508,5,20,.250,13,16,.813,92,33,77,.429,26,60,.433,7,17,.412,17,22,.773,90
10,2012-12-18,MIN,@,MIA,L 92-103,240,37,86,.430,33,69,.478,4,17,.235,14,19,.737,92,36,77,.468,23,52,.442,13,25,.520,18,23,.783,103
11,2012-12-23,PHI,@,BRK,L 92-95,240,38,88,.432,30,70,.429,8,18,.444,8,10,.800,92,33,74,.446,25,52,.481,8,22,.364,21,30,.700,95
12,2013-01-02,NOH,@,HOU,L 92-104,240,38,90,.422,33,74,.446,5,16,.313,11,20,.550,92,41,83,.494,36,59,.610,5,24,.208,17,23,.739,104
13,2013-01-06,MEM,@,PHO,W 92-81,240,37,69,.536,35,61,.574,2,8,.250,16,20,.800,92,31,79,.392,26,65,.400,5,14,.357,14,18,.778,81
14,2013-01-07,CLE,@,CHI,L 92-118,240,33,78,.423,26,64,.406,7,14,.500,19,23,.826,92,44,82,.537,34,68,.500,10,14,.714,20,24,.833,118
15,2013-01-11,MIN,@,NOH,L 92-104,240,31,69,.449,27,51,.529,4,18,.222,26,33,.788,92,44,84,.524,36,62,.581,8,22,.364,8,9,.889,104
16,2013-01-16,MIA,@,GSW,W 92-75,240,36,90,.400,28,61,.459,8,29,.276,12,18,.667,92,29,80,.363,26,68,.382,3,12,.250,14,18,.778,75
17,2013-01-30,TOR,@,ATL,L 92-93,240,33,85,.388,24,63,.381,9,22,.409,17,23,.739,92,36,75,.480,26,49,.531,10,26,.385,11,18,.611,93
18,2013-02-05,LAL,@,BRK,W 92-83,240,37,82,.451,34,69,.493,3,13,.231,15,18,.833,92,31,89,.348,25,66,.379,6,23,.261,15,19,.789,83
19,2013-02-06,MEM,@,ATL,L 92-103,240,38,84,.452,33,72,.458,5,12,.417,11,16,.688,92,38,74,.514,28,50,.560,10,24,.417,17,23,.739,103
20,2013-02-13,PHI,@,MIL,L 92-94,240,34,76,.447,30,63,.476,4,13,.308,20,24,.833,92,37,88,.420,33,70,.471,4,18,.222,16,21,.762,94
21,2013-02-13,TOR,@,NYK,W 92-88,240,31,73,.425,22,52,.423,9,21,.429,21,24,.875,92,28,79,.354,19,54,.352,9,25,.360,23,32,.719,88
22,2013-02-27,TOR,@,CLE,L 92-103,240,35,78,.449,33,58,.569,2,20,.100,20,25,.800,92,34,82,.415,29,69,.420,5,13,.385,30,32,.938,103
23,2013-03-03,CHI,@,IND,L 92-97,240,35,81,.432,27,62,.435,8,19,.421,14,18,.778,92,33,71,.465,27,58,.466,6,13,.462,25,33,.758,97
24,2013-03-07,LAC,@,DEN,L 92-107,240,36,85,.424,29,63,.460,7,22,.318,13,16,.813,92,43,77,.558,32,54,.593,11,23,.478,10,12,.833,107
25,2013-03-13,LAL,@,ATL,L 92-96,240,36,92,.391,28,63,.444,8,29,.276,12,16,.750,92,37,79,.468,29,57,.509,8,22,.364,14,21,.667,96
26,2013-03-23,DET,@,CHA,W 92-91,240,36,79,.456,26,53,.491,10,26,.385,10,14,.714,92,32,75,.427,28,58,.483,4,17,.235,23,25,.920,91
27,2013-03-23,WAS,@,GSW,L 92-101,240,36,88,.409,29,71,.408,7,17,.412,13,16,.813,92,37,75,.493,27,55,.491,10,20,.500,17,22,.773,101
28,2013-03-27,MIL,@,PHI,L 92-100,240,37,89,.416,31,65,.477,6,24,.250,12,13,.923,92,42,89,.472,34,73,.466,8,16,.500,8,9,.889,100
29,2013-03-29,WAS,@,ORL,L 92-97,240,30,81,.370,26,61,.426,4,20,.200,28,32,.875,92,37,86,.430,32,71,.451,5,15,.333,18,22,.818,97
30,2013-03-30,CHA,@,PHI,L 92-100,240,38,76,.500,36,68,.529,2,8,.250,14,23,.609,92,38,73,.521,33,57,.579,5,16,.313,19,27,.704,100
31,2013-03-31,CLE,@,NOH,L 92-112,240,38,82,.463,31,64,.484,7,18,.389,9,12,.750,92,40,74,.541,28,53,.528,12,21,.571,20,29,.690,112
32,2013-03-31,TOR,@,WAS,L 92-109,240,32,81,.395,25,62,.403,7,19,.368,21,26,.808,92,41,85,.482,32,68,.471,9,17,.529,18,28,.643,109
33,2013-04-04,CHI,@,BRK,W 92-90,240,38,82,.463,34,71,.479,4,11,.364,12,19,.632,92,31,70,.443,26,57,.456,5,13,.385,23,30,.767,90
34,2013-04-17,WAS,@,CHI,L 92-95,240,36,85,.424,29,69,.420,7,16,.438,13,17,.765,92,37,78,.474,30,60,.500,7,18,.389,14,19,.737,95
35,2013-04-17,ATL,@,NYK,L 92-98,240,37,90,.411,35,69,.507,2,21,.095,16,17,.941,92,39,91,.429,30,67,.448,9,24,.375,11,16,.688,98
36,2012-11-05,POR,@,DAL,L 91-114,240,36,93,.387,31,71,.437,5,22,.227,14,18,.778,91,48,78,.615,38,58,.655,10,20,.500,8,13,.615,114
37,2012-11-11,CLE,@,OKC,L 91-106,240,34,83,.410,27,60,.450,7,23,.304,16,23,.696,91,40,73,.548,33,58,.569,7,15,.467,19,22,.864,106
38,2012-11-19,HOU,@,UTA,L 91-102,240,30,86,.349,23,65,.354,7,21,.333,24,31,.774,91,37,92,.402,28,71,.394,9,21,.429,19,23,.826,102
39,2012-11-23,GSW,@,DEN,L 91-102,240,35,80,.438,28,63,.444,7,17,.412,14,18,.778,91,40,84,.476,35,65,.538,5,19,.263,17,30,.567,102
40,2012-11-27,PHO,@,CLE,W 91-78,240,37,79,.468,31,62,.500,6,17,.353,11,18,.611,91,30,84,.357,28,69,.406,2,15,.133,16,22,.727,78
41,2012-11-28,CHA,@,ATL,L 91-94,240,30,76,.395,18,52,.346,12,24,.500,19,23,.826,91,36,90,.400,24,58,.414,12,32,.375,10,15,.667,94
42,2012-12-19,CLE,@,BOS,L 91-103,240,36,88,.409,31,70,.443,5,18,.278,14,21,.667,91,37,62,.597,28,45,.622,9,17,.529,20,27,.741,103
43,2012-12-19,DET,@,TOR,L 91-97,240,35,84,.417,32,72,.444,3,12,.250,18,30,.600,91,35,72,.486,25,43,.581,10,29,.345,17,22,.773,97
44,2012-12-23,MIN,@,NYK,L 91-94,240,34,84,.405,27,62,.435,7,22,.318,16,18,.889,91,32,72,.444,26,46,.565,6,26,.231,24,28,.857,94
45,2012-12-23,DAL,@,SAS,L 91-129,240,34,74,.459,29,60,.483,5,14,.357,18,29,.621,91,47,84,.560,27,54,.500,20,30,.667,15,19,.789,129
46,2012-12-26,SAC,@,POR,L 91-109,240,35,86,.407,26,62,.419,9,24,.375,12,16,.750,91,44,87,.506,38,66,.576,6,21,.286,15,20,.750,109
47,2012-12-28,PHO,@,IND,L 91-97,240,38,82,.463,36,68,.529,2,14,.143,13,16,.813,91,34,77,.442,26,61,.426,8,16,.500,21,29,.724,97
48,2012-12-31,CHA,@,CHI,W 91-81,240,33,70,.471,29,60,.483,4,10,.400,21,38,.553,91,33,94,.351,29,78,.372,4,16,.250,11,18,.611,81
49,2013-01-05,UTA,@,DEN,L 91-110,240,28,78,.359,19,53,.358,9,25,.360,26,35,.743,91,39,76,.513,35,65,.538,4,11,.364,28,39,.718,110
50,2013-01-11,HOU,@,BOS,L 91-103,240,35,80,.438,26,47,.553,9,33,.273,12,29,.414,91,41,79,.519,32,56,.571,9,23,.391,12,16,.750,103
51,2013-01-11,CLE,@,DEN,L 91-98,240,37,85,.435,32,61,.525,5,24,.208,12,16,.750,91,36,82,.439,32,66,.485,4,16,.250,22,31,.710,98
52,2013-01-14,ORL,@,WAS,L 91-120,240,37,87,.425,32,69,.464,5,18,.278,12,15,.800,91,46,82,.561,39,71,.549,7,11,.636,21,25,.840,120
53,2013-01-23,BRK,@,MIN,W 91-83,240,37,84,.440,31,64,.484,6,20,.300,11,16,.688,91,38,83,.458,35,68,.515,3,15,.200,4,6,.667,83
54,2013-01-27,NOH,@,MEM,W 91-83,240,33,77,.429,24,57,.421,9,20,.450,16,23,.696,91,32,88,.364,29,72,.403,3,16,.188,16,18,.889,83
55,2013-02-04,DAL,@,OKC,L 91-112,240,36,87,.414,33,71,.465,3,16,.188,16,20,.800,91,41,87,.471,31,62,.500,10,25,.400,20,27,.741,112
1,2013-02-04,SAC,@,UTA,L 91-98,265,35,87,.402,32,67,.478,3,20,.150,18,25,.720,91,38,72,.528,31,60,.517,7,12,.583,15,18,.833,98
2,2013-02-09,GSW,@,DAL,L 91-116,240,34,89,.382,28,73,.384,6,16,.375,17,24,.708,91,38,77,.494,27,57,.474,11,20,.550,29,38,.763,116
3,2013-02-11,BOS,@,CHA,L 91-94,240,32,77,.416,26,63,.413,6,14,.429,21,26,.808,91,33,77,.429,25,59,.424,8,18,.444,20,30,.667,94
4,2013-02-20,NYK,@,IND,L 91-125,240,29,86,.337,24,58,.414,5,28,.179,28,36,.778,91,42,79,.532,31,55,.564,11,24,.458,30,39,.769,125
5,2013-03-01,MEM,@,MIA,L 91-98,240,33,77,.429,29,64,.453,4,13,.308,21,27,.778,91,34,73,.466,24,54,.444,10,19,.526,20,27,.741,98
6,2013-03-10,IND,@,MIA,L 91-105,240,26,63,.413,16,36,.444,10,27,.370,29,34,.853,91,38,68,.559,31,54,.574,7,14,.500,22,31,.710,105
7,2013-03-10,PHI,@,ORL,L 91-99,240,40,86,.465,35,74,.473,5,12,.417,6,10,.600,91,41,83,.494,29,56,.518,12,27,.444,5,7,.714,99
8,2013-03-13,MIN,@,IND,L 91-107,240,35,80,.438,29,61,.475,6,19,.316,15,18,.833,91,41,82,.500,32,57,.561,9,25,.360,16,26,.615,107
9,2013-03-14,DAL,@,SAS,L 91-92,240,37,83,.446,29,64,.453,8,19,.421,9,10,.900,91,37,84,.440,32,71,.451,5,13,.385,13,17,.765,92
10,2013-03-16,IND,@,PHI,L 91-98,240,34,88,.386,28,72,.389,6,16,.375,17,21,.810,91,39,79,.494,33,66,.500,6,13,.462,14,19,.737,98
11,2013-03-25,PHI,@,UTA,L 91-107,240,32,83,.386,28,69,.406,4,14,.286,23,28,.821,91,41,84,.488,34,70,.486,7,14,.500,18,21,.857,107
12,2013-04-13,LAC,@,MEM,W 91-87,240,37,80,.463,31,64,.484,6,16,.375,11,18,.611,91,34,83,.410,28,70,.400,6,13,.462,13,20,.650,87
13,2012-10-31,IND,@,TOR,W 90-88,240,37,78,.474,32,67,.478,5,11,.455,11,16,.688,90,33,91,.363,27,74,.365,6,17,.353,16,19,.842,88
14,2012-11-11,SAC,@,LAL,L 90-103,240,36,90,.400,29,67,.433,7,23,.304,11,14,.786,90,36,81,.444,28,56,.500,8,25,.320,23,30,.767,103
15,2012-11-12,MIN,@,DAL,W 90-82,240,30,65,.462,26,50,.520,4,15,.267,26,32,.813,90,29,80,.363,25,64,.391,4,16,.250,20,25,.800,82
16,2012-11-20,BRK,@,LAL,L 90-95,240,34,82,.415,27,59,.458,7,23,.304,15,21,.714,90,35,73,.479,29,52,.558,6,21,.286,19,37,.514,95
17,2012-11-23,TOR,@,DET,L 90-91,240,32,78,.410,26,60,.433,6,18,.333,20,25,.800,90,36,78,.462,32,65,.492,4,13,.308,15,26,.577,91
18,2012-12-05,DAL,@,LAC,L 90-112,240,34,84,.405,29,65,.446,5,19,.263,17,19,.895,90,45,90,.500,39,70,.557,6,20,.300,16,21,.762,112
19,2012-12-08,NOH,@,MIA,L 90-106,240,35,78,.449,27,60,.450,8,18,.444,12,13,.923,90,40,69,.580,33,58,.569,7,11,.636,19,24,.792,106
20,2012-12-13,CHA,@,ATL,L 90-113,240,34,79,.430,28,58,.483,6,21,.286,16,20,.800,90,43,75,.573,29,46,.630,14,29,.483,13,23,.565,113
21,2012-12-13,SAS,@,POR,L 90-98,240,33,72,.458,27,53,.509,6,19,.316,18,25,.720,90,40,88,.455,33,61,.541,7,27,.259,11,12,.917,98
22,2012-12-14,MIL,@,CLE,W 90-86,240,33,83,.398,28,68,.412,5,15,.333,19,27,.704,90,32,81,.395,23,63,.365,9,18,.500,13,14,.929,86
23,2012-12-17,SAC,@,PHO,L 90-101,240,34,83,.410,31,70,.443,3,13,.231,19,24,.792,90,41,85,.482,33,63,.524,8,22,.364,11,15,.733,101
24,2012-12-21,ORL,@,TOR,L 90-93,240,35,70,.500,31,56,.554,4,14,.286,16,19,.842,90,33,81,.407,25,62,.403,8,19,.421,19,21,.905,93
25,2013-01-10,MIA,@,POR,L 90-92,240,35,77,.455,29,58,.500,6,19,.316,14,20,.700,90,30,80,.375,21,53,.396,9,27,.333,23,30,.767,92
26,2013-01-12,UTA,@,DET,W 90-87,240,36,71,.507,31,61,.508,5,10,.500,13,18,.722,90,34,65,.523,28,49,.571,6,16,.375,13,21,.619,87
27,2013-01-16,NOH,@,BOS,W 90-78,240,31,71,.437,29,54,.537,2,17,.118,26,31,.839,90,34,74,.459,30,56,.536,4,18,.222,6,16,.375,78
28,2013-01-17,LAC,@,MIN,W 90-77,240,35,77,.455,30,64,.469,5,13,.385,15,23,.652,90,30,84,.357,26,65,.400,4,19,.211,13,20,.650,77
29,2013-01-21,SAS,@,PHI,W 90-85,240,34,81,.420,31,63,.492,3,18,.167,19,26,.731,90,37,84,.440,33,70,.471,4,14,.286,7,11,.636,85
30,2013-01-22,BOS,@,CLE,L 90-95,240,32,84,.381,25,67,.373,7,17,.412,19,22,.864,90,37,82,.451,35,70,.500,2,12,.167,19,22,.864,95
31,2013-01-22,ORL,@,DET,L 90-105,240,38,84,.452,30,64,.469,8,20,.400,6,8,.750,90,42,91,.462,35,68,.515,7,23,.304,14,21,.667,105
32,2013-02-04,LAC,@,WAS,L 90-98,240,37,79,.468,33,62,.532,4,17,.235,12,15,.800,90,37,84,.440,30,72,.417,7,12,.583,17,27,.630,98
33,2013-02-19,BOS,@,DEN,L 90-97,240,35,79,.443,28,59,.475,7,20,.350,13,16,.813,90,33,77,.429,26,57,.456,7,20,.350,24,36,.667,97
34,2013-02-23,IND,@,DET,W 90-72,240,34,75,.453,26,53,.491,8,22,.364,14,19,.737,90,26,77,.338,24,63,.381,2,14,.143,18,24,.750,72
35,2013-02-25,WAS,@,TOR,W 90-84,240,34,81,.420,27,69,.391,7,12,.583,15,17,.882,90,29,79,.367,24,60,.400,5,19,.263,21,27,.778,84
36,2013-03-11,DET,@,UTA,L 90-103,240,34,80,.425,27,60,.450,7,20,.350,15,18,.833,90,42,81,.519,36,65,.554,6,16,.375,13,15,.867,103
37,2013-03-12,WAS,@,CLE,L 90-95,240,31,76,.408,26,59,.441,5,17,.294,23,28,.821,90,34,83,.410,26,57,.456,8,26,.308,19,25,.760,95
38,2013-03-14,NYK,@,POR,L 90-105,240,36,82,.439,29,57,.509,7,25,.280,11,17,.647,90,40,78,.513,30,50,.600,10,28,.357,15,21,.714,105
39,2013-03-18,NYK,@,UTA,W 90-83,240,32,69,.464,24,46,.522,8,23,.348,18,25,.720,90,29,76,.382,20,57,.351,9,19,.474,16,24,.667,83
40,2013-03-20,MIL,@,ATL,L 90-98,240,37,99,.374,29,80,.363,8,19,.421,8,11,.727,90,38,79,.481,30,61,.492,8,18,.444,14,17,.824,98
41,2013-04-01,SAS,@,MEM,L 90-92,240,36,75,.480,28,52,.538,8,23,.348,10,11,.909,90,36,79,.456,34,72,.472,2,7,.286,18,24,.750,92
42,2013-04-09,OKC,@,UTA,W 90-80,240,32,81,.395,23,60,.383,9,21,.429,17,18,.944,90,31,79,.392,24,54,.444,7,25,.280,11,14,.786,80
43,2013-04-17,BOS,@,TOR,L 90-114,240,37,84,.440,30,67,.448,7,17,.412,9,13,.692,90,40,80,.500,28,59,.475,12,21,.571,22,28,.786,114
1,2012-11-02,IND,@,CHA,L 89-90,240,33,83,.398,26,57,.456,7,26,.269,16,27,.593,89,31,85,.365,24,66,.364,7,19,.368,21,24,.875,90
2,2012-11-02,DEN,@,ORL,L 89-102,240,32,84,.381,25,58,.431,7,26,.269,18,27,.667,89,42,86,.488,37,71,.521,5,15,.333,13,18,.722,102
3,2012-11-02,DET,@,PHO,L 89-92,240,37,90,.411,33,77,.429,4,13,.308,11,19,.579,89,40,92,.435,38,81,.469,2,11,.182,10,14,.714,92
4,2012-11-03,NOH,@,CHI,W 89-82,240,32,75,.427,27,57,.474,5,18,.278,20,23,.870,89,29,88,.330,26,71,.366,3,17,.176,21,25,.840,82
5,2012-11-03,BOS,@,WAS,W 89-86,240,36,84,.429,28,63,.444,8,21,.381,9,13,.692,89,34,78,.436,28,58,.483,6,20,.300,12,17,.706,86
6,2012-11-14,CHA,@,MIN,W 89-87,240,38,84,.452,34,68,.500,4,16,.250,9,14,.643,89,31,81,.383,26,62,.419,5,19,.263,20,37,.541,87
7,2012-11-17,TOR,@,BOS,L 89-107,240,30,70,.429,22,48,.458,8,22,.364,21,31,.677,89,43,76,.566,37,61,.607,6,15,.400,15,19,.789,107
8,2012-11-21,CHI,@,HOU,L 89-93,240,38,95,.400,36,79,.456,2,16,.125,11,19,.579,89,32,74,.432,25,55,.455,7,19,.368,22,31,.710,93
9,2012-11-26,NYK,@,BRK,L 89-96,265,33,85,.388,27,64,.422,6,21,.286,17,24,.708,89,37,91,.407,28,63,.444,9,28,.321,13,19,.684,96
10,2012-12-01,BRK,@,MIA,L 89-102,240,33,75,.440,27,47,.574,6,28,.214,17,27,.630,89,40,78,.513,33,58,.569,7,20,.350,15,19,.789,102
11,2012-12-14,BOS,@,HOU,L 89-101,240,34,85,.400,26,65,.400,8,20,.400,13,17,.765,89,37,76,.487,27,49,.551,10,27,.370,17,23,.739,101
12,2012-12-18,BOS,@,CHI,L 89-100,240,35,81,.432,30,71,.423,5,10,.500,14,19,.737,89,37,74,.500,32,65,.492,5,9,.556,21,24,.875,100
13,2012-12-22,UTA,@,MIA,L 89-105,240,30,73,.411,23,57,.404,7,16,.438,22,26,.846,89,38,73,.521,27,49,.551,11,24,.458,18,22,.818,105
14,2012-12-28,PHI,@,GSW,L 89-96,240,35,87,.402,30,67,.448,5,20,.250,14,23,.609,89,34,80,.425,27,63,.429,7,17,.412,21,26,.808,96
15,2013-01-02,PHI,@,PHO,L 89-95,240,37,84,.440,32,70,.457,5,14,.357,10,12,.833,89,39,85,.459,36,72,.500,3,13,.231,14,20,.700,95
16,2013-01-05,BOS,@,ATL,W 89-81,240,39,85,.459,36,69,.522,3,16,.188,8,12,.667,89,28,68,.412,18,39,.462,10,29,.345,15,19,.789,81
17,2013-01-05,GSW,@,LAC,L 89-115,240,32,72,.444,27,52,.519,5,20,.250,20,26,.769,89,47,90,.522,37,62,.597,10,28,.357,11,15,.733,115
18,2013-01-14,CHA,@,BOS,L 89-100,240,33,79,.418,27,64,.422,6,15,.400,17,24,.708,89,39,80,.488,31,59,.525,8,21,.381,14,20,.700,100
19,2013-01-18,ATL,@,BRK,L 89-94,240,35,80,.438,26,59,.441,9,21,.429,10,14,.714,89,30,74,.405,21,48,.438,9,26,.346,25,38,.658,94
20,2013-01-24,NYK,@,BOS,W 89-86,240,32,83,.386,24,55,.436,8,28,.286,17,20,.850,89,31,76,.408,28,58,.483,3,18,.167,21,28,.750,86
21,2013-01-31,MEM,@,OKC,L 89-106,240,34,98,.347,28,73,.384,6,25,.240,15,19,.789,89,40,72,.556,35,58,.603,5,14,.357,21,25,.840,106
22,2013-02-01,CHI,@,BRK,L 89-93,240,34,78,.436,33,64,.516,1,14,.071,20,22,.909,89,39,75,.520,34,64,.531,5,11,.455,10,20,.500,93
23,2013-02-01,MIA,@,IND,L 89-102,240,33,70,.471,28,56,.500,5,14,.357,18,24,.750,89,39,70,.557,32,53,.604,7,17,.412,17,24,.708,102
24,2013-02-08,LAC,@,MIA,L 89-111,240,34,77,.442,27,61,.443,7,16,.438,14,19,.737,89,36,68,.529,21,41,.512,15,27,.556,24,32,.750,111
25,2013-02-10,NOH,@,TOR,L 89-102,240,34,69,.493,29,56,.518,5,13,.385,16,25,.640,89,40,78,.513,32,62,.516,8,16,.500,14,18,.778,102
26,2013-02-11,BRK,@,IND,W 89-84,265,31,80,.388,27,68,.397,4,12,.333,23,32,.719,89,33,96,.344,28,74,.378,5,22,.227,13,18,.722,84
27,2013-03-20,OKC,@,MEM,L 89-90,265,30,84,.357,28,66,.424,2,18,.111,27,32,.844,89,32,89,.360,26,74,.351,6,15,.400,20,24,.833,90
28,2013-03-22,DET,@,MIA,L 89-103,240,34,83,.410,27,61,.443,7,22,.318,14,18,.778,89,38,68,.559,30,53,.566,8,15,.533,19,26,.731,103
29,2013-03-31,BOS,@,NYK,L 89-108,240,32,74,.432,25,49,.510,7,25,.280,18,23,.783,89,35,72,.486,21,45,.467,14,27,.519,24,31,.774,108
30,2013-04-05,MIA,@,CHA,W 89-79,240,31,69,.449,18,36,.500,13,33,.394,14,17,.824,89,28,88,.318,25,72,.347,3,16,.188,20,22,.909,79
31,2013-04-07,MEM,@,SAC,W 89-87,240,32,73,.438,29,66,.439,3,7,.429,22,29,.759,89,29,81,.358,22,56,.393,7,25,.280,22,28,.786,87
32,2013-04-09,MIN,@,GSW,L 89-105,240,33,90,.367,26,71,.366,7,19,.368,16,20,.800,89,39,91,.429,29,67,.433,10,24,.417,17,22,.773,105
33,2012-11-06,TOR,@,OKC,L 88-108,240,30,84,.357,23,54,.426,7,30,.233,21,25,.840,88,35,74,.473,26,49,.531,9,25,.360,29,34,.853,108
34,2012-11-14,ATL,@,GSW,L 88-92,240,34,78,.436,27,55,.491,7,23,.304,13,18,.722,88,33,71,.465,28,53,.528,5,18,.278,21,25,.840,92
35,2012-12-01,PHI,@,CHI,L 88-93,240,36,82,.439,33,70,.471,3,12,.250,13,18,.722,88,38,81,.469,34,74,.459,4,7,.571,13,21,.619,93
36,2012-12-01,BOS,@,MIL,L 88-91,240,34,82,.415,28,63,.444,6,19,.316,14,17,.824,88,36,79,.456,32,66,.485,4,13,.308,15,20,.750,91
37,2012-12-12,NOH,@,OKC,L 88-92,240,33,83,.398,24,61,.393,9,22,.409,13,16,.813,88,31,71,.437,26,56,.464,5,15,.333,25,32,.781,92
38,2012-12-15,IND,@,DET,W 88-77,240,35,72,.486,28,48,.583,7,24,.292,11,16,.688,88,32,83,.386,29,70,.414,3,13,.231,10,15,.667,77
39,2012-12-15,BOS,@,SAS,L 88-103,240,38,81,.469,32,65,.492,6,16,.375,6,8,.750,88,38,81,.469,26,56,.464,12,25,.480,15,20,.750,103
40,2012-12-17,LAC,@,DET,W 88-76,240,35,78,.449,30,56,.536,5,22,.227,13,17,.765,88,29,71,.408,22,51,.431,7,20,.350,11,19,.579,76
41,2012-12-22,CHA,@,DEN,L 88-110,240,33,87,.379,30,67,.448,3,20,.150,19,30,.633,88,47,92,.511,41,72,.569,6,20,.300,10,15,.667,110
42,2013-01-07,SAS,@,NOH,L 88-95,240,33,73,.452,27,52,.519,6,21,.286,16,20,.800,88,40,83,.482,35,70,.500,5,13,.385,10,12,.833,95
43,2013-01-12,CHA,@,IND,L 88-96,240,36,78,.462,33,71,.465,3,7,.429,13,16,.813,88,38,89,.427,27,61,.443,11,28,.393,9,12,.750,96
44,2013-01-13,MIN,@,SAS,L 88-106,240,33,89,.371,29,73,.397,4,16,.250,18,23,.783,88,45,80,.563,37,59,.627,8,21,.381,8,11,.727,106
45,2013-01-15,MIL,@,LAL,L 88-104,240,34,95,.358,27,67,.403,7,28,.250,13,22,.591,88,42,84,.500,32,55,.582,10,29,.345,10,18,.556,104
46,2013-01-18,GSW,@,SAS,L 88-95,240,36,84,.429,32,68,.471,4,16,.250,12,14,.857,88,36,80,.450,31,58,.534,5,22,.227,18,20,.900,95
47,2013-01-20,BOS,@,DET,L 88-103,240,33,83,.398,29,68,.426,4,15,.267,18,25,.720,88,36,78,.462,27,59,.458,9,19,.474,22,31,.710,103
48,2013-01-21,BRK,@,NYK,W 88-85,240,31,74,.419,19,50,.380,12,24,.500,14,20,.700,88,34,84,.405,28,63,.444,6,21,.286,11,17,.647,85
49,2013-01-23,WAS,@,UTA,L 88-92,240,31,86,.360,24,68,.353,7,18,.389,19,26,.731,88,38,85,.447,35,73,.479,3,12,.250,13,19,.684,92
50,2013-01-24,LAC,@,PHO,L 88-93,240,33,83,.398,27,65,.415,6,18,.333,16,26,.615,88,30,71,.423,25,55,.455,5,16,.313,28,37,.757,93
51,2013-01-25,DET,@,MIA,L 88-110,240,34,72,.472,30,60,.500,4,12,.333,16,23,.696,88,43,77,.558,38,60,.633,5,17,.294,19,23,.826,110
52,2013-02-06,IND,@,PHI,W 88-69,240,32,81,.395,27,64,.422,5,17,.294,19,25,.760,88,31,89,.348,29,81,.358,2,8,.250,5,7,.714,69
53,2013-02-10,MIN,@,MEM,L 88-105,240,34,69,.493,30,53,.566,4,16,.250,16,25,.640,88,41,79,.519,35,66,.530,6,13,.462,17,22,.773,105
1,2013-02-20,MEM,@,TOR,W 88-82,240,29,80,.363,23,67,.343,6,13,.462,24,34,.706,88,26,71,.366,18,53,.340,8,18,.444,22,26,.846,82
2,2013-03-04,ATL,@,DEN,L 88-104,240,36,89,.404,29,65,.446,7,24,.292,9,11,.818,88,46,86,.535,41,71,.577,5,15,.333,7,9,.778,104
3,2013-03-08,UTA,@,CHI,L 88-89,240,37,81,.457,35,71,.493,2,10,.200,12,18,.667,88,30,81,.370,26,64,.406,4,17,.235,25,30,.833,89
4,2013-03-09,MIN,@,DEN,L 88-111,240,35,84,.417,30,66,.455,5,18,.278,13,19,.684,88,42,78,.538,33,61,.541,9,17,.529,18,22,.818,111
5,2013-03-13,TOR,@,BOS,L 88-112,240,34,79,.430,31,66,.470,3,13,.231,17,19,.895,88,39,76,.513,33,61,.541,6,15,.400,28,35,.800,112
6,2013-03-16,CHA,@,BOS,L 88-105,240,34,76,.447,27,56,.482,7,20,.350,13,21,.619,88,41,79,.519,31,64,.484,10,15,.667,13,20,.650,105
7,2013-03-20,WAS,@,PHO,W 88-79,240,33,68,.485,27,53,.509,6,15,.400,16,25,.640,88,28,83,.337,25,68,.368,3,15,.200,20,22,.909,79
8,2013-03-27,PHO,@,UTA,L 88-103,240,34,76,.447,28,60,.467,6,16,.375,14,19,.737,88,44,85,.518,38,70,.543,6,15,.400,9,13,.692,103
9,2013-03-30,ORL,@,ATL,L 88-97,240,34,87,.391,30,74,.405,4,13,.308,16,27,.593,88,34,78,.436,28,57,.491,6,21,.286,23,31,.742,97
10,2013-03-31,MIA,@,SAS,W 88-86,240,33,71,.465,21,43,.488,12,28,.429,10,15,.667,88,35,79,.443,28,55,.509,7,24,.292,9,16,.563,86
11,2013-04-03,NOH,@,GSW,L 88-98,240,33,83,.398,29,68,.426,4,15,.267,18,23,.783,88,36,78,.462,29,59,.492,7,19,.368,19,22,.864,98
12,2013-04-04,SAS,@,OKC,L 88-100,240,33,83,.398,25,62,.403,8,21,.381,14,17,.824,88,38,82,.463,26,58,.448,12,24,.500,12,13,.923,100
13,2013-04-12,CHI,@,TOR,L 88-97,240,34,77,.442,25,59,.424,9,18,.500,11,14,.786,88,34,72,.472,32,64,.500,2,8,.250,27,33,.818,97
14,2012-10-31,SAC,@,CHI,L 87-93,240,34,84,.405,28,67,.418,6,17,.353,13,16,.813,87,33,79,.418,31,70,.443,2,9,.222,25,33,.758,93
15,2012-10-31,GSW,@,PHO,W 87-85,240,33,86,.384,28,69,.406,5,17,.294,16,23,.696,87,32,80,.400,28,59,.475,4,21,.190,17,22,.773,85
16,2012-11-21,POR,@,PHO,L 87-114,240,31,77,.403,26,58,.448,5,19,.263,20,26,.769,87,46,77,.597,39,60,.650,7,17,.412,15,18,.833,114
17,2012-11-30,WAS,@,NYK,L 87-108,240,35,78,.449,30,60,.500,5,18,.278,12,21,.571,87,43,81,.531,31,52,.596,12,29,.414,10,15,.667,108
18,2012-12-26,HOU,@,MIN,W 87-84,240,33,81,.407,24,50,.480,9,31,.290,12,15,.800,87,32,84,.381,25,56,.446,7,28,.250,13,17,.765,84
19,2012-12-26,CLE,@,WAS,W 87-84,240,31,82,.378,21,55,.382,10,27,.370,15,23,.652,87,35,76,.461,31,58,.534,4,18,.222,10,14,.714,84
20,2012-12-28,POR,@,LAL,L 87-104,240,36,87,.414,33,68,.485,3,19,.158,12,16,.750,87,40,86,.465,33,62,.532,7,24,.292,17,28,.607,104
21,2013-01-04,UTA,@,PHO,W 87-80,240,40,89,.449,39,80,.488,1,9,.111,6,9,.667,87,34,75,.453,30,60,.500,4,15,.267,8,11,.727,80
22,2013-01-13,NOH,@,NYK,L 87-100,240,33,82,.402,29,59,.492,4,23,.174,17,22,.773,87,35,81,.432,24,51,.471,11,30,.367,19,25,.760,100
23,2013-01-13,OKC,@,POR,W 87-83,240,32,71,.451,26,48,.542,6,23,.261,17,22,.773,87,31,86,.360,25,65,.385,6,21,.286,15,18,.833,83
24,2013-01-19,WAS,@,LAC,L 87-94,240,32,77,.416,24,57,.421,8,20,.400,15,27,.556,87,34,93,.366,29,72,.403,5,21,.238,21,31,.677,94
25,2013-01-25,GSW,@,CHI,L 87-103,240,27,78,.346,23,59,.390,4,19,.211,29,33,.879,87,41,88,.466,32,68,.471,9,20,.450,12,18,.667,103
26,2013-02-20,PHI,@,MIN,L 87-94,240,31,81,.383,27,68,.397,4,13,.308,21,32,.656,87,28,70,.400,23,57,.404,5,13,.385,33,44,.750,94
27,2013-03-01,ATL,@,PHO,L 87-92,240,31,73,.425,23,50,.460,8,23,.348,17,22,.773,87,36,81,.444,26,59,.441,10,22,.455,10,12,.833,92
28,2013-03-03,PHI,@,WAS,L 87-90,240,33,85,.388,27,66,.409,6,19,.316,15,20,.750,87,34,80,.425,28,65,.431,6,15,.400,16,21,.762,90
29,2013-03-06,NYK,@,DET,W 87-77,240,31,75,.413,18,40,.450,13,35,.371,12,15,.800,87,32,74,.432,25,54,.463,7,20,.350,6,10,.600,77
30,2013-03-09,CHA,@,WAS,L 87-104,240,32,79,.405,27,64,.422,5,15,.333,18,23,.783,87,35,70,.500,25,52,.481,10,18,.556,24,32,.750,104
31,2013-03-13,UTA,@,OKC,L 87-110,240,28,80,.350,23,65,.354,5,15,.333,26,33,.788,87,37,69,.536,30,53,.566,7,16,.438,29,33,.879,110
32,2013-03-15,NOH,@,WAS,L 87-96,240,35,80,.438,32,61,.525,3,19,.158,14,19,.737,87,36,72,.500,27,52,.519,9,20,.450,15,19,.789,96
33,2013-03-29,BRK,@,DEN,L 87-109,240,32,79,.405,27,59,.458,5,20,.250,18,36,.500,87,42,74,.568,38,60,.633,4,14,.286,21,31,.677,109
34,2013-04-06,PHI,@,MIA,L 87-106,240,33,82,.402,27,62,.435,6,20,.300,15,20,.750,87,40,83,.482,26,58,.448,14,25,.560,12,14,.857,106
35,2013-04-14,BRK,@,TOR,L 87-93,240,34,84,.405,26,54,.481,8,30,.267,11,19,.579,87,36,82,.439,30,67,.448,6,15,.400,15,21,.714,93
36,2013-04-17,NOH,@,DAL,L 87-99,240,31,84,.369,27,73,.370,4,11,.364,21,28,.750,87,42,82,.512,36,66,.545,6,16,.375,9,11,.818,99
37,2012-11-02,UTA,@,NOH,L 86-88,240,35,85,.412,25,57,.439,10,28,.357,6,12,.500,86,37,81,.457,32,67,.478,5,14,.357,9,14,.643,88
38,2012-11-04,MIN,@,TOR,L 86-105,240,29,64,.453,23,48,.479,6,16,.375,22,31,.710,86,40,90,.444,30,69,.435,10,21,.476,15,17,.882,105
39,2012-11-07,IND,@,ATL,L 86-89,240,35,85,.412,27,59,.458,8,26,.308,8,9,.889,86,38,87,.437,31,65,.477,7,22,.318,6,12,.500,89
40,2012-11-07,LAL,@,UTA,L 86-95,240,25,74,.338,21,51,.412,4,23,.174,32,46,.696,86,37,83,.446,32,66,.485,5,17,.294,16,18,.889,95
41,2012-11-11,MIA,@,MEM,L 86-104,240,30,79,.380,26,64,.406,4,15,.267,22,36,.611,86,38,86,.442,24,62,.387,14,24,.583,14,16,.875,104
42,2012-11-18,ORL,@,TOR,L 86-97,240,32,80,.400,28,67,.418,4,13,.308,18,21,.857,86,38,80,.475,31,62,.500,7,18,.389,14,23,.609,97
43,2012-12-12,ATL,@,ORL,W 86-80,240,35,80,.438,29,58,.500,6,22,.273,10,16,.625,86,31,81,.383,24,59,.407,7,22,.318,11,11,1.000,80
44,2012-12-19,BRK,@,NYK,L 86-100,240,35,78,.449,25,53,.472,10,25,.400,6,9,.667,86,38,83,.458,27,54,.500,11,29,.379,13,17,.765,100
45,2013-01-04,POR,@,MEM,W 86-84,240,33,81,.407,23,54,.426,10,27,.370,10,15,.667,86,32,81,.395,30,76,.395,2,5,.400,18,18,1.000,84
46,2013-01-05,PHI,@,SAS,L 86-109,240,35,84,.417,32,67,.478,3,17,.176,13,20,.650,86,41,85,.482,33,60,.550,8,25,.320,19,23,.826,109
47,2013-01-13,IND,@,BRK,L 86-97,240,35,83,.422,29,59,.492,6,24,.250,10,12,.833,86,33,81,.407,27,67,.403,6,14,.429,25,31,.806,97
48,2013-01-16,IND,@,ORL,L 86-97,240,37,85,.435,35,68,.515,2,17,.118,10,12,.833,86,40,86,.465,28,65,.431,12,21,.571,5,5,1.000,97
1,2013-01-30,LAL,@,PHO,L 86-92,240,33,78,.423,25,51,.490,8,27,.296,12,19,.632,86,38,83,.458,35,71,.493,3,12,.250,13,15,.867,92
2,2013-02-01,MIL,@,NYK,L 86-96,240,33,83,.398,25,63,.397,8,20,.400,12,17,.706,86,32,76,.421,19,41,.463,13,35,.371,19,26,.731,96
3,2013-02-02,NOH,@,MIN,L 86-115,240,28,70,.400,25,56,.446,3,14,.214,27,33,.818,86,45,77,.584,40,62,.645,5,15,.333,20,29,.690,115
4,2013-02-02,WAS,@,SAS,L 86-96,240,36,88,.409,30,66,.455,6,22,.273,8,17,.471,86,38,78,.487,33,58,.569,5,20,.250,15,16,.938,96
5,2013-02-06,LAC,@,ORL,W 86-76,240,33,82,.402,27,64,.422,6,18,.333,14,22,.636,86,30,87,.345,24,67,.358,6,20,.300,10,14,.714,76
6,2013-02-06,MIL,@,UTA,L 86-100,240,29,82,.354,23,63,.365,6,19,.316,22,29,.759,86,39,81,.481,34,71,.479,5,10,.500,17,26,.654,100
7,2013-02-21,MIA,@,CHI,W 86-67,240,37,73,.507,34,60,.567,3,13,.231,9,14,.643,86,28,75,.373,26,65,.400,2,10,.200,9,11,.818,67
8,2013-02-24,BOS,@,POR,L 86-92,240,36,85,.424,34,72,.472,2,13,.154,12,15,.800,86,35,79,.443,28,58,.483,7,21,.333,15,19,.789,92
9,2013-03-01,GSW,@,BOS,L 86-94,240,32,94,.340,27,71,.380,5,23,.217,17,22,.773,86,36,75,.480,33,60,.550,3,15,.200,19,28,.679,94
10,2013-03-15,CLE,@,DAL,L 86-96,240,34,78,.436,27,62,.435,7,16,.438,11,18,.611,86,41,82,.500,34,61,.557,7,21,.333,7,11,.636,96
11,2013-03-20,BOS,@,NOH,L 86-87,240,33,72,.458,29,58,.500,4,14,.286,16,17,.941,86,31,71,.437,26,55,.473,5,16,.313,20,26,.769,87
12,2013-03-25,DEN,@,NOH,L 86-110,240,25,66,.379,20,50,.400,5,16,.313,31,39,.795,86,41,85,.482,27,60,.450,14,25,.560,14,15,.933,110
13,2013-04-02,CHI,@,WAS,L 86-90,240,35,89,.393,30,66,.455,5,23,.217,11,16,.688,86,33,78,.423,27,65,.415,6,13,.462,18,26,.692,90
14,2013-04-05,ORL,@,CHI,L 86-87,240,34,80,.425,30,70,.429,4,10,.400,14,17,.824,86,33,82,.402,25,62,.403,8,20,.400,13,14,.929,87
15,2013-04-10,SAS,@,DEN,L 86-96,240,35,87,.402,31,66,.470,4,21,.190,12,17,.706,86,39,86,.453,33,71,.465,6,15,.400,12,21,.571,96
16,2013-04-14,SAS,@,LAL,L 86-91,240,33,89,.371,27,71,.380,6,18,.333,14,19,.737,86,31,85,.365,22,58,.379,9,27,.333,20,31,.645,91
17,2012-11-09,HOU,@,MEM,L 85-93,240,31,76,.408,22,49,.449,9,27,.333,14,15,.933,85,35,94,.372,29,75,.387,6,19,.316,17,23,.739,93
18,2012-11-10,WAS,@,IND,L 85-89,240,35,79,.443,25,55,.455,10,24,.417,5,7,.714,85,34,80,.425,27,64,.422,7,16,.438,14,24,.583,89
19,2012-11-14,IND,@,MIL,L 85-99,240,30,80,.375,25,60,.417,5,20,.250,20,31,.645,85,38,91,.418,35,75,.467,3,16,.188,20,25,.800,99
20,2012-11-24,MIN,@,GSW,L 85-96,240,33,86,.384,28,59,.475,5,27,.185,14,19,.737,85,33,78,.423,27,57,.474,6,21,.286,24,29,.828,96
21,2012-11-25,POR,@,BRK,L 85-98,240,34,78,.436,27,61,.443,7,17,.412,10,13,.769,85,39,92,.424,34,75,.453,5,17,.294,15,21,.714,98
22,2012-11-30,MIL,@,MIN,L 85-95,240,34,93,.366,29,75,.387,5,18,.278,12,16,.750,85,34,87,.391,26,68,.382,8,19,.421,19,27,.704,95
23,2012-12-08,NYK,@,CHI,L 85-93,240,27,84,.321,19,61,.311,8,23,.348,23,28,.821,85,34,78,.436,27,65,.415,7,13,.538,18,18,1.000,93
24,2012-12-12,SAC,@,MIL,L 85-98,240,32,86,.372,29,67,.433,3,19,.158,18,21,.857,85,39,96,.406,33,79,.418,6,17,.353,14,24,.583,98
25,2012-12-14,PHI,@,IND,L 85-95,240,35,81,.432,32,69,.464,3,12,.250,12,16,.750,85,35,77,.455,27,63,.429,8,14,.571,17,27,.630,95
26,2012-12-14,GSW,@,ORL,L 85-99,240,34,92,.370,27,72,.375,7,20,.350,10,11,.909,85,41,86,.477,32,65,.492,9,21,.429,8,11,.727,99
27,2012-12-21,SAC,@,LAC,L 85-97,240,33,79,.418,25,57,.439,8,22,.364,11,16,.688,85,37,87,.425,30,64,.469,7,23,.304,16,24,.667,97
28,2012-12-29,MIA,@,MIL,L 85-104,240,33,76,.434,29,63,.460,4,13,.308,15,24,.625,85,40,98,.408,32,77,.416,8,21,.381,16,17,.941,104
29,2012-12-29,PHI,@,POR,L 85-89,240,36,85,.424,32,68,.471,4,17,.235,9,11,.818,85,34,76,.447,26,53,.491,8,23,.348,13,16,.813,89
30,2013-01-04,PHI,@,OKC,L 85-109,240,34,84,.405,23,60,.383,11,24,.458,6,8,.750,85,39,75,.520,29,58,.500,10,17,.588,21,27,.778,109
31,2013-01-19,MEM,@,CHI,W 85-82,265,34,84,.405,34,79,.430,0,5,.000,17,28,.607,85,31,85,.365,28,71,.394,3,14,.214,17,21,.810,82
32,2013-01-28,CHA,@,CHI,L 85-93,240,32,81,.395,26,69,.377,6,12,.500,15,21,.714,85,35,78,.449,28,60,.467,7,18,.389,16,25,.640,93
33,2013-02-04,DET,@,NYK,L 85-99,240,38,90,.422,35,77,.455,3,13,.231,6,12,.500,85,36,79,.456,22,45,.489,14,34,.412,13,16,.813,99
34,2013-02-12,PHO,@,LAL,L 85-91,240,35,85,.412,32,72,.444,3,13,.231,12,17,.706,85,36,83,.434,29,62,.468,7,21,.333,12,18,.667,91
35,2013-02-13,WAS,@,DET,L 85-96,240,34,70,.486,31,59,.525,3,11,.273,14,22,.636,85,35,79,.443,26,61,.426,9,18,.500,17,25,.680,96
36,2013-03-02,BRK,@,CHI,L 85-96,240,32,72,.444,27,57,.474,5,15,.333,16,23,.696,85,38,73,.521,32,58,.552,6,15,.400,14,14,1.000,96
37,2013-03-06,POR,@,MEM,L 85-91,240,31,76,.408,25,56,.446,6,20,.300,17,28,.607,85,38,87,.437,34,75,.453,4,12,.333,11,18,.611,91
38,2013-03-09,NOH,@,MEM,L 85-96,240,34,79,.430,32,67,.478,2,12,.167,15,17,.882,85,38,81,.469,34,68,.500,4,13,.308,16,20,.800,96
39,2013-04-06,IND,@,WAS,L 85-104,240,35,86,.407,32,66,.485,3,20,.150,12,15,.800,85,39,79,.494,35,67,.522,4,12,.333,22,31,.710,104
40,2013-04-07,ORL,@,CLE,L 85-91,240,34,90,.378,33,77,.429,1,13,.077,16,22,.727,85,32,89,.360,25,72,.347,7,17,.412,20,24,.833,91
41,2013-04-07,CHI,@,DET,L 85-99,240,33,73,.452,30,58,.517,3,15,.200,16,25,.640,85,39,73,.534,30,55,.545,9,18,.500,12,17,.706,99
42,2013-04-13,MIL,@,CHA,L 85-95,240,34,87,.391,25,58,.431,9,29,.310,8,12,.667,85,37,80,.463,33,71,.465,4,9,.444,17,24,.708,95
43,2012-10-30,WAS,@,CLE,L 84-94,240,32,90,.356,24,58,.414,8,32,.250,12,20,.600,84,36,79,.456,29,59,.492,7,20,.350,15,22,.682,94
44,2012-11-01,OKC,@,SAS,L 84-86,240,29,77,.377,22,60,.367,7,17,.412,19,23,.826,84,35,79,.443,30,60,.500,5,19,.263,11,16,.688,86
45,2012-11-02,MIA,@,NYK,L 84-104,240,33,71,.465,26,51,.510,7,20,.350,11,13,.846,84,36,84,.429,17,48,.354,19,36,.528,13,15,.867,104
46,2012-11-04,PHI,@,NYK,L 84-100,240,34,79,.430,26,62,.419,8,17,.471,8,10,.800,84,39,77,.506,28,50,.560,11,27,.407,11,18,.611,100
47,2012-11-07,SAS,@,LAC,L 84-106,240,30,73,.411,22,50,.440,8,23,.348,16,24,.667,84,46,83,.554,40,66,.606,6,17,.353,8,9,.889,106
48,2012-11-09,UTA,@,DEN,L 84-104,240,32,87,.368,28,64,.438,4,23,.174,16,22,.727,84,40,92,.435,34,75,.453,6,17,.353,18,25,.720,104
49,2012-11-13,SAS,@,LAL,W 84-82,240,35,90,.389,28,70,.400,7,20,.350,7,11,.636,84,31,74,.419,25,54,.463,6,20,.300,14,22,.636,82
50,2012-11-25,NOH,@,DEN,L 84-102,240,33,85,.388,27,72,.375,6,13,.462,12,20,.600,84,40,75,.533,35,62,.565,5,13,.385,17,21,.810,102
51,2012-12-14,UTA,@,PHO,L 84-99,240,33,82,.402,30,71,.423,3,11,.273,15,21,.714,84,38,83,.458,32,70,.457,6,13,.462,17,22,.773,99
52,2012-12-19,UTA,@,IND,L 84-104,240,32,86,.372,30,71,.423,2,15,.133,18,25,.720,84,41,80,.513,32,64,.500,9,16,.563,13,18,.722,104
53,2013-01-02,MIN,@,UTA,L 84-106,240,29,84,.345,27,67,.403,2,17,.118,24,30,.800,84,43,87,.494,39,75,.520,4,12,.333,16,19,.842,106
54,2013-01-04,ATL,@,DET,L 84-85,240,31,75,.413,21,46,.457,10,29,.345,12,20,.600,84,35,85,.412,32,70,.457,3,15,.200,12,21,.571,85
55,2013-01-09,MIN,@,OKC,L 84-106,240,31,72,.431,28,60,.467,3,12,.250,19,24,.792,84,36,76,.474,25,56,.446,11,20,.550,23,27,.852,106
56,2013-01-25,UTA,@,LAL,L 84-102,240,34,81,.420,31,67,.463,3,14,.214,13,16,.813,84,43,80,.538,34,59,.576,9,21,.429,7,13,.538,102
57,2013-01-30,WAS,@,PHI,L 84-92,240,30,75,.400,23,53,.434,7,22,.318,17,21,.810,84,40,95,.421,34,82,.415,6,13,.462,6,10,.600,92
58,2013-02-01,ORL,@,BOS,L 84-97,240,36,95,.379,33,76,.434,3,19,.158,9,9,1.000,84,42,84,.500,38,66,.576,4,18,.222,9,14,.643,97
59,2013-02-06,PHO,@,NOH,L 84-93,240,35,78,.449,34,63,.540,1,15,.067,13,15,.867,84,39,75,.520,35,61,.574,4,14,.286,11,17,.647,93
60,2013-02-26,CHA,@,LAC,L 84-106,240,33,81,.407,27,65,.415,6,16,.375,12,14,.857,84,41,76,.539,29,54,.537,12,22,.545,12,26,.462,106
61,2013-02-27,DAL,@,MEM,L 84-90,240,33,76,.434,30,64,.469,3,12,.250,15,19,.789,84,29,78,.372,24,64,.375,5,14,.357,27,34,.794,90
62,2013-03-09,UTA,@,NYK,L 84-113,240,30,78,.385,22,52,.423,8,26,.308,16,21,.762,84,38,75,.507,25,43,.581,13,32,.406,24,30,.800,113
1,2013-03-16,MEM,@,UTA,L 84-90,240,33,77,.429,29,65,.446,4,12,.333,14,22,.636,84,31,71,.437,26,55,.473,5,16,.313,23,31,.742,90
2,2013-03-23,IND,@,CHI,L 84-87,240,30,78,.385,25,64,.391,5,14,.357,19,24,.792,84,35,81,.432,32,70,.457,3,11,.273,14,22,.636,87
3,2013-03-23,TOR,@,NYK,L 84-110,240,34,76,.447,30,53,.566,4,23,.174,12,18,.667,84,41,79,.519,34,60,.567,7,19,.368,21,23,.913,110
4,2013-04-03,ORL,@,SAS,L 84-98,240,35,90,.389,29,73,.397,6,17,.353,8,9,.889,84,40,90,.444,30,61,.492,10,29,.345,8,13,.615,98
5,2013-04-05,MEM,@,LAL,L 84-86,240,38,86,.442,35,72,.486,3,14,.214,5,7,.714,84,34,74,.459,29,54,.537,5,20,.250,13,18,.722,86
6,2012-11-16,DAL,@,IND,L 83-103,240,30,81,.370,28,68,.412,2,13,.154,21,25,.840,83,39,83,.470,33,67,.493,6,16,.375,19,31,.613,103
7,2012-11-17,UTA,@,WAS,W 83-76,240,31,82,.378,29,73,.397,2,9,.222,19,27,.704,83,31,85,.365,26,69,.377,5,16,.313,9,12,.750,76
8,2012-11-18,BOS,@,DET,L 83-103,240,32,71,.451,28,54,.519,4,17,.235,15,19,.789,83,39,72,.542,35,61,.574,4,11,.364,21,26,.808,103
9,2012-11-21,PHI,@,CLE,L 83-92,240,31,86,.360,27,69,.391,4,17,.235,17,22,.773,83,35,86,.407,22,63,.349,13,23,.565,9,14,.643,92
10,2012-12-09,TOR,@,LAC,L 83-102,240,30,77,.390,20,51,.392,10,26,.385,13,17,.765,83,36,79,.456,30,60,.500,6,19,.316,24,34,.706,102
11,2012-12-19,WAS,@,ORL,L 83-90,240,34,77,.442,25,60,.417,9,17,.529,6,8,.750,83,34,81,.420,26,61,.426,8,20,.400,14,17,.824,90
12,2012-12-29,BOS,@,GSW,L 83-101,240,31,86,.360,26,64,.406,5,22,.227,16,21,.762,83,38,73,.521,26,54,.481,12,19,.632,13,16,.813,101
13,2012-12-31,MEM,@,IND,L 83-88,240,31,82,.378,28,71,.394,3,11,.273,18,24,.750,83,28,70,.400,16,45,.356,12,25,.480,20,24,.833,88
14,2013-01-03,SAS,@,NYK,L 83-100,240,28,77,.364,19,43,.442,9,34,.265,18,21,.857,83,39,82,.476,27,55,.491,12,27,.444,10,16,.625,100
15,2013-01-09,ATL,@,CLE,L 83-99,240,37,84,.440,30,62,.484,7,22,.318,2,5,.400,83,37,81,.457,25,58,.431,12,23,.522,13,20,.650,99
16,2013-01-12,MEM,@,DAL,L 83-104,240,32,84,.381,29,76,.382,3,8,.375,16,26,.615,83,39,80,.488,28,63,.444,11,17,.647,15,21,.714,104
17,2013-01-12,ATL,@,WAS,L 83-93,240,30,78,.385,23,54,.426,7,24,.292,16,25,.640,83,36,79,.456,34,68,.500,2,11,.182,19,27,.704,93
18,2013-01-21,LAL,@,CHI,L 83-95,240,32,81,.395,29,64,.453,3,17,.176,16,23,.696,83,39,93,.419,30,76,.395,9,17,.529,8,12,.667,95
19,2013-01-27,POR,@,LAC,L 83-96,240,29,66,.439,26,51,.510,3,15,.200,22,29,.759,83,42,82,.512,36,65,.554,6,17,.353,6,9,.667,96
20,2013-02-26,MIN,@,PHO,L 83-84,265,31,90,.344,26,71,.366,5,19,.263,16,25,.640,83,37,91,.407,32,78,.410,5,13,.385,5,14,.357,84
21,2013-03-03,CHA,@,SAC,L 83-119,240,28,77,.364,22,54,.407,6,23,.261,21,27,.778,83,42,90,.467,29,57,.509,13,33,.394,22,27,.815,119
22,2013-03-06,SAC,@,GSW,L 83-87,240,33,83,.398,25,59,.424,8,24,.333,9,12,.750,83,27,75,.360,19,52,.365,8,23,.348,25,29,.862,87
23,2013-03-06,BOS,@,IND,W 83-81,240,34,83,.410,27,66,.409,7,17,.412,8,9,.889,83,32,88,.364,26,61,.426,6,27,.222,11,14,.786,81
24,2013-03-06,CHI,@,SAS,L 83-101,240,33,90,.367,24,70,.343,9,20,.450,8,8,1.000,83,40,74,.541,32,60,.533,8,14,.571,13,18,.722,101
25,2013-03-12,SAS,@,MIN,L 83-107,240,29,82,.354,20,53,.377,9,29,.310,16,18,.889,83,44,82,.537,32,62,.516,12,20,.600,7,18,.389,107
26,2013-03-22,MEM,@,NOH,L 83-90,240,30,73,.411,27,63,.429,3,10,.300,20,25,.800,83,36,76,.474,32,62,.516,4,14,.286,14,18,.778,90
27,2013-03-24,POR,@,OKC,L 83-103,240,32,79,.405,22,53,.415,10,26,.385,9,13,.692,83,43,82,.524,39,71,.549,4,11,.364,13,18,.722,103
28,2013-04-03,PHI,@,CHA,L 83-88,240,33,94,.351,29,78,.372,4,16,.250,13,16,.813,83,35,81,.432,31,67,.463,4,14,.286,14,16,.875,88
29,2013-04-05,MIL,@,NYK,L 83-101,240,29,76,.382,17,46,.370,12,30,.400,13,18,.722,83,41,89,.461,29,53,.547,12,36,.333,7,8,.875,101
30,2013-04-05,NOH,@,UTA,L 83-95,240,32,77,.416,30,65,.462,2,12,.167,17,20,.850,83,39,77,.506,28,51,.549,11,26,.423,6,11,.545,95
31,2013-04-06,TOR,@,MIL,L 83-100,240,30,83,.361,27,73,.370,3,10,.300,20,23,.870,83,36,76,.474,30,57,.526,6,19,.316,22,29,.759,100
32,2013-04-09,PHI,@,BRK,L 83-104,240,30,80,.375,23,66,.348,7,14,.500,16,20,.800,83,42,93,.452,37,73,.507,5,20,.250,15,23,.652,104
33,2013-04-09,MIL,@,MIA,L 83-94,240,33,75,.440,24,50,.480,9,25,.360,8,14,.571,83,38,88,.432,30,53,.566,8,35,.229,10,10,1.000,94
34,2012-11-10,DET,@,HOU,L 82-96,240,32,80,.400,25,60,.417,7,20,.350,11,16,.688,82,33,82,.402,24,56,.429,9,26,.346,21,26,.808,96
35,2012-11-28,TOR,@,MEM,L 82-103,240,29,74,.392,24,57,.421,5,17,.294,19,24,.792,82,38,80,.475,30,62,.484,8,18,.444,19,28,.679,103
36,2012-11-28,POR,@,WAS,L 82-84,240,30,86,.349,20,55,.364,10,31,.323,12,18,.667,82,31,71,.437,26,59,.441,5,12,.417,17,19,.895,84
37,2012-12-07,ORL,@,SAC,L 82-91,240,30,80,.375,26,65,.400,4,15,.267,18,21,.857,82,32,79,.405,28,58,.483,4,21,.190,23,28,.821,91
38,2012-12-15,BRK,@,CHI,L 82-83,240,29,75,.387,22,56,.393,7,19,.368,17,22,.773,82,33,75,.440,31,65,.477,2,10,.200,15,19,.789,83
39,2012-12-21,DAL,@,MEM,L 82-92,240,31,76,.408,25,55,.455,6,21,.286,14,17,.824,82,36,89,.404,33,76,.434,3,13,.231,17,20,.850,92
40,2013-01-16,MEM,@,SAS,L 82-103,240,29,69,.420,28,60,.467,1,9,.111,23,28,.821,82,44,76,.579,35,58,.603,9,18,.500,6,10,.600,103
41,2013-01-21,IND,@,MEM,W 82-81,240,34,69,.493,26,52,.500,8,17,.471,6,11,.545,82,35,83,.422,31,73,.425,4,10,.400,7,7,1.000,81
42,2013-01-23,DET,@,CHI,L 82-85,240,34,82,.415,30,69,.435,4,13,.308,10,14,.714,82,31,71,.437,28,57,.491,3,14,.214,20,26,.769,85
43,2013-02-22,DET,@,IND,L 82-114,240,29,82,.354,26,63,.413,3,19,.158,21,37,.568,82,41,73,.562,31,59,.525,10,14,.714,22,33,.667,114
44,2013-02-22,ORL,@,MEM,L 82-88,240,35,84,.417,30,69,.435,5,15,.333,7,9,.778,82,34,76,.447,31,60,.517,3,16,.188,17,29,.586,88
45,2013-02-28,PHI,@,CHI,L 82-93,240,33,85,.388,29,74,.392,4,11,.364,12,21,.571,82,32,83,.386,29,69,.420,3,14,.214,26,33,.788,93
46,2013-03-06,WAS,@,MIN,L 82-87,240,29,65,.446,23,46,.500,6,19,.316,18,22,.818,82,31,76,.408,27,62,.435,4,14,.286,21,31,.677,87
47,2013-04-12,MEM,@,HOU,W 82-78,240,29,83,.349,24,66,.364,5,17,.294,19,28,.679,82,23,74,.311,12,42,.286,11,32,.344,21,28,.750,78
48,2012-11-10,PHO,@,UTA,L 81-94,240,32,87,.368,28,71,.394,4,16,.250,13,17,.765,81,38,78,.487,36,64,.563,2,14,.143,16,24,.667,94
49,2012-12-01,SAC,@,LAC,L 81-116,240,29,76,.382,20,53,.377,9,23,.391,14,18,.778,81,47,86,.547,35,62,.565,12,24,.500,10,16,.625,116
50,2012-12-03,MIL,@,NOH,L 81-102,240,29,76,.382,21,57,.368,8,19,.421,15,23,.652,81,43,82,.524,38,70,.543,5,12,.417,11,11,1.000,102
51,2012-12-05,ORL,@,UTA,L 81-87,240,34,77,.442,33,62,.532,1,15,.067,12,17,.706,81,32,77,.416,31,67,.463,1,10,.100,22,27,.815,87
52,2012-12-12,CLE,@,IND,L 81-96,240,27,81,.333,18,59,.305,9,22,.409,18,25,.720,81,34,83,.410,29,65,.446,5,18,.278,23,28,.821,96
53,2012-12-22,IND,@,NOH,W 81-75,240,33,77,.429,29,60,.483,4,17,.235,11,18,.611,81,33,82,.402,29,71,.408,4,11,.364,5,7,.714,75
54,2012-12-28,CHA,@,BRK,L 81-97,240,28,73,.384,25,63,.397,3,10,.300,22,32,.688,81,34,76,.447,25,49,.510,9,27,.333,20,26,.769,97
55,2013-01-02,WAS,@,IND,L 81-89,240,35,83,.422,32,70,.457,3,13,.231,8,10,.800,81,29,77,.377,24,61,.393,5,16,.313,26,31,.839,89
56,2013-01-30,SAC,@,BOS,L 81-99,240,29,73,.397,23,56,.411,6,17,.353,17,26,.654,81,39,73,.534,34,57,.596,5,16,.313,16,20,.800,99
57,2013-02-02,SAC,@,NYK,L 81-120,240,32,76,.421,26,55,.473,6,21,.286,11,15,.733,81,47,86,.547,28,43,.651,19,43,.442,7,13,.538,120
58,2013-03-10,CHI,@,LAL,L 81-90,240,33,89,.371,29,73,.397,4,16,.250,11,12,.917,81,39,86,.453,34,60,.567,5,26,.192,7,14,.500,90
59,2013-03-12,ATL,@,MIA,L 81-98,240,33,78,.423,28,56,.500,5,22,.227,10,14,.714,81,35,82,.427,29,62,.468,6,20,.300,22,30,.733,98
60,2013-03-13,PHO,@,HOU,L 81-111,240,34,81,.420,28,60,.467,6,21,.286,7,10,.700,81,39,76,.513,29,55,.527,10,21,.476,23,30,.767,111
61,2013-03-30,LAC,@,HOU,L 81-98,240,31,78,.397,24,56,.429,7,22,.318,12,14,.857,81,35,80,.438,26,56,.464,9,24,.375,19,27,.704,98
62,2013-04-02,DAL,@,LAL,L 81-101,240,34,81,.420,27,62,.435,7,19,.368,6,12,.500,81,36,81,.444,28,57,.491,8,24,.333,21,33,.636,101
1,2012-11-02,SAC,@,MIN,L 80-92,240,32,89,.360,29,73,.397,3,16,.188,13,16,.813,80,32,87,.368,30,70,.429,2,17,.118,26,36,.722,92
2,2012-11-10,MIN,@,CHI,L 80-87,240,33,85,.388,30,72,.417,3,13,.231,11,15,.733,80,34,80,.425,28,67,.418,6,13,.462,13,16,.813,87
3,2012-11-17,CHI,@,LAC,L 80-101,240,30,89,.337,28,75,.373,2,14,.143,18,22,.818,80,37,75,.493,32,59,.542,5,16,.313,22,30,.733,101
4,2012-12-04,IND,@,CHI,W 80-76,240,29,80,.363,27,70,.386,2,10,.200,20,27,.741,80,28,73,.384,24,61,.393,4,12,.333,16,20,.800,76
5,2012-12-12,MEM,@,PHO,L 80-82,240,33,73,.452,31,63,.492,2,10,.200,12,12,1.000,80,34,89,.382,29,67,.433,5,22,.227,9,11,.818,82
6,2012-12-19,MIL,@,MEM,L 80-90,240,30,85,.353,25,65,.385,5,20,.250,15,19,.789,80,36,88,.409,33,80,.413,3,8,.375,15,19,.789,90
7,2012-12-21,ATL,@,PHI,L 80-99,240,31,79,.392,22,54,.407,9,25,.360,9,12,.750,80,44,86,.512,36,67,.537,8,19,.421,3,7,.429,99
8,2012-12-26,TOR,@,SAS,L 80-100,240,33,78,.423,26,60,.433,7,18,.389,7,12,.583,80,34,71,.479,26,52,.500,8,19,.421,24,29,.828,100
9,2013-01-05,MIL,@,IND,L 80-95,240,31,82,.378,26,64,.406,5,18,.278,13,18,.722,80,40,92,.435,37,72,.514,3,20,.150,12,20,.600,95
10,2013-01-23,IND,@,POR,L 80-100,240,30,80,.375,24,57,.421,6,23,.261,14,17,.824,80,44,78,.564,42,67,.627,2,11,.182,10,12,.833,100
11,2013-01-26,NYK,@,PHI,L 80-97,240,28,81,.346,24,54,.444,4,27,.148,20,23,.870,80,38,75,.507,32,56,.571,6,19,.316,15,22,.682,97
12,2013-02-01,SAC,@,PHI,L 80-89,240,30,79,.380,29,69,.420,1,10,.100,19,25,.760,80,36,76,.474,33,62,.532,3,14,.214,14,19,.737,89
13,2013-03-15,MEM,@,DEN,L 80-87,240,30,85,.353,26,73,.356,4,12,.333,16,19,.842,80,35,77,.455,34,65,.523,1,12,.083,16,22,.727,87
14,2013-03-17,NYK,@,LAC,L 80-93,240,29,81,.358,17,55,.309,12,26,.462,10,14,.714,80,34,75,.453,26,47,.553,8,28,.286,17,31,.548,93
15,2013-03-27,WAS,@,OKC,L 80-103,240,27,84,.321,22,64,.344,5,20,.250,21,29,.724,80,29,63,.460,21,49,.429,8,14,.571,37,41,.902,103
16,2013-04-14,IND,@,NYK,L 80-90,240,28,65,.431,20,37,.541,8,28,.286,16,26,.615,80,35,82,.427,24,51,.471,11,31,.355,9,11,.818,90
17,2012-11-04,DET,@,LAL,L 79-108,240,28,79,.354,24,66,.364,4,13,.308,19,23,.826,79,40,77,.519,30,55,.545,10,22,.455,18,26,.692,108
18,2012-11-05,IND,@,SAS,L 79-101,240,27,79,.342,21,59,.356,6,20,.300,19,22,.864,79,41,87,.471,33,69,.478,8,18,.444,11,13,.846,101
19,2012-11-18,CLE,@,PHI,L 79-86,240,30,84,.357,25,64,.391,5,20,.250,14,15,.933,79,34,80,.425,25,60,.417,9,20,.450,9,12,.750,86
20,2012-11-27,IND,@,LAL,W 79-77,240,29,79,.367,25,60,.417,4,19,.211,17,27,.630,79,24,76,.316,18,48,.375,6,28,.214,23,43,.535,77
21,2012-12-03,CLE,@,DET,L 79-89,240,32,95,.337,29,75,.387,3,20,.150,12,17,.706,79,36,84,.429,32,66,.485,4,18,.222,13,19,.684,89
22,2012-12-08,PHI,@,BOS,L 79-92,240,31,79,.392,27,62,.435,4,17,.235,13,16,.813,79,40,75,.533,36,61,.590,4,14,.286,8,12,.667,92
23,2013-01-02,POR,@,TOR,L 79-102,240,31,70,.443,27,48,.563,4,22,.182,13,16,.813,79,41,77,.532,33,54,.611,8,23,.348,12,17,.706,102
24,2013-01-09,PHO,@,BOS,L 79-87,240,33,84,.393,31,72,.431,2,12,.167,11,18,.611,79,37,81,.457,34,67,.507,3,14,.214,10,12,.833,87
25,2013-01-09,HOU,@,NOH,L 79-88,240,30,75,.400,21,48,.438,9,27,.333,10,13,.769,79,35,84,.417,30,65,.462,5,19,.263,13,16,.813,88
26,2013-01-11,PHO,@,BRK,L 79-99,240,31,79,.392,24,65,.369,7,14,.500,10,16,.625,79,34,75,.453,28,62,.452,6,13,.462,25,32,.781,99
27,2013-01-19,HOU,@,MIN,L 79-92,240,25,78,.321,17,47,.362,8,31,.258,21,28,.750,79,30,64,.469,27,50,.540,3,14,.214,29,36,.806,92
28,2013-01-30,DET,@,IND,L 79-98,240,32,88,.364,29,70,.414,3,18,.167,12,27,.444,79,36,81,.444,29,67,.433,7,14,.500,19,21,.905,98
29,2013-03-10,BOS,@,OKC,L 79-91,240,29,77,.377,22,57,.386,7,20,.350,14,20,.700,79,30,68,.441,26,52,.500,4,16,.250,27,33,.818,91
30,2013-03-13,CHI,@,SAC,L 79-121,240,32,83,.386,30,62,.484,2,21,.095,13,15,.867,79,45,83,.542,36,60,.600,9,23,.391,22,26,.846,121
31,2012-11-26,CLE,@,MEM,L 78-84,240,31,76,.408,27,60,.450,4,16,.250,12,15,.800,78,33,71,.465,29,60,.483,4,11,.364,14,18,.778,84
32,2012-11-28,DAL,@,CHI,L 78-101,240,28,81,.346,24,63,.381,4,18,.222,18,20,.900,78,34,69,.493,28,59,.475,6,10,.600,27,33,.818,101
33,2012-11-30,POR,@,BOS,L 78-96,240,24,69,.348,21,54,.389,3,15,.200,27,37,.730,78,36,73,.493,30,57,.526,6,16,.375,18,20,.900,96
34,2012-11-30,DET,@,MEM,L 78-90,240,29,72,.403,25,56,.446,4,16,.250,16,20,.800,78,34,85,.400,30,73,.411,4,12,.333,18,21,.857,90
35,2013-01-01,LAC,@,DEN,L 78-92,240,30,78,.385,25,49,.510,5,29,.172,13,29,.448,78,37,82,.451,30,59,.508,7,23,.304,11,21,.524,92
36,2013-01-11,CHA,@,TOR,L 78-99,240,28,75,.373,25,63,.397,3,12,.250,19,22,.864,78,39,86,.453,27,59,.458,12,27,.444,9,11,.818,99
37,2013-01-30,CHA,@,SAS,L 78-102,240,30,73,.411,26,54,.481,4,19,.211,14,17,.824,78,38,69,.551,29,53,.547,9,16,.563,17,21,.810,102
38,2013-03-08,WAS,@,BRK,L 78-95,240,32,90,.356,29,73,.397,3,17,.176,11,17,.647,78,32,81,.395,20,54,.370,12,27,.444,19,33,.576,95
39,2013-03-15,CHA,@,TOR,L 78-92,240,26,80,.325,20,58,.345,6,22,.273,20,29,.690,78,33,68,.485,30,58,.517,3,10,.300,23,27,.852,92
40,2013-03-22,CLE,@,HOU,L 78-116,240,31,86,.360,27,66,.409,4,20,.200,12,15,.800,78,44,77,.571,34,48,.708,10,29,.345,18,27,.667,116
41,2013-03-22,MIL,@,IND,L 78-102,240,31,101,.307,28,82,.341,3,19,.158,13,22,.591,78,38,79,.481,35,67,.522,3,12,.250,23,30,.767,102
42,2013-04-03,WAS,@,TOR,L 78-88,240,26,80,.325,21,61,.344,5,19,.263,21,29,.724,78,30,66,.455,29,58,.500,1,8,.125,27,36,.750,88
43,2012-11-07,PHI,@,NOH,W 77-62,240,35,84,.417,31,62,.500,4,22,.182,3,5,.600,77,23,69,.333,19,50,.380,4,19,.211,12,16,.750,62
44,2012-11-09,GSW,@,LAL,L 77-101,240,29,86,.337,22,61,.361,7,25,.280,12,20,.600,77,36,90,.400,28,62,.452,8,28,.286,21,28,.750,101
45,2012-11-28,PHO,@,DET,L 77-117,240,28,82,.341,22,61,.361,6,21,.286,15,20,.750,77,40,76,.526,28,60,.467,12,16,.750,25,35,.714,117
46,2012-12-01,DET,@,DAL,L 77-92,240,29,85,.341,24,64,.375,5,21,.238,14,18,.778,77,38,93,.409,27,68,.397,11,25,.440,5,8,.625,92
47,2012-12-11,WAS,@,NOH,W 77-70,240,27,82,.329,22,63,.349,5,19,.263,18,23,.783,77,26,80,.325,22,64,.344,4,16,.250,14,22,.636,70
48,2012-12-19,NOH,@,LAC,L 77-93,240,29,75,.387,27,56,.482,2,19,.105,17,22,.773,77,37,74,.500,33,54,.611,4,20,.200,15,19,.789,93
49,2012-12-27,BOS,@,LAC,L 77-106,240,29,72,.403,23,56,.411,6,16,.375,13,15,.867,77,41,85,.482,29,55,.527,12,30,.400,12,24,.500,106
50,2012-12-29,WAS,@,CHI,L 77-87,240,31,85,.365,28,75,.373,3,10,.300,12,18,.667,77,34,87,.391,27,71,.380,7,16,.438,12,18,.667,87
51,2013-01-08,MIA,@,IND,L 77-87,240,28,68,.412,20,49,.408,8,19,.421,13,18,.722,77,33,91,.363,24,69,.348,9,22,.409,12,19,.632,87
52,2013-01-25,BRK,@,MEM,L 77-101,240,29,71,.408,26,54,.481,3,17,.176,16,25,.640,77,47,90,.522,43,81,.531,4,9,.444,3,8,.375,101
53,2013-01-28,ORL,@,BRK,L 77-97,240,32,79,.405,26,52,.500,6,27,.222,7,9,.778,77,37,74,.500,24,45,.533,13,29,.448,10,12,.833,97
54,2013-02-01,POR,@,UTA,L 77-86,240,29,79,.367,22,59,.373,7,20,.350,12,16,.750,77,35,81,.432,31,66,.470,4,15,.267,12,17,.706,86
55,2013-02-13,CHA,@,IND,L 77-101,240,26,82,.317,21,66,.318,5,16,.313,20,28,.714,77,41,95,.432,35,76,.461,6,19,.316,13,19,.684,101
56,2013-03-18,MIN,@,MEM,L 77-92,240,29,86,.337,23,62,.371,6,24,.250,13,18,.722,77,40,82,.488,35,66,.530,5,16,.313,7,11,.636,92
57,2013-03-24,CHA,@,MIA,L 77-109,240,30,89,.337,25,64,.391,5,25,.200,12,18,.667,77,38,76,.500,25,46,.543,13,30,.433,20,23,.870,109
58,2013-04-14,CLE,@,PHI,L 77-91,240,31,85,.365,26,69,.377,5,16,.313,10,15,.667,77,38,86,.442,30,65,.462,8,21,.381,7,11,.636,91
59,2013-04-16,POR,@,LAC,L 77-93,240,30,73,.411,23,52,.442,7,21,.333,10,15,.667,77,37,79,.468,30,52,.577,7,27,.259,12,15,.800,93
60,2012-11-11,ATL,@,LAC,L 76-89,240,30,72,.417,21,47,.447,9,25,.360,7,16,.438,76,38,82,.463,33,67,.493,5,15,.333,8,8,1.000,89
61,2012-11-13,WAS,@,CHA,L 76-92,240,25,84,.298,20,53,.377,5,31,.161,21,32,.656,76,31,78,.397,28,65,.431,3,13,.231,27,32,.844,92
62,2012-11-18,IND,@,NYK,L 76-88,240,28,71,.394,20,51,.392,8,20,.400,12,18,.667,76,33,90,.367,26,65,.400,7,25,.280,15,19,.789,88
63,2012-11-23,LAC,@,BRK,L 76-86,240,29,72,.403,25,55,.455,4,17,.235,14,22,.636,76,34,73,.466,29,60,.483,5,13,.385,13,19,.684,86
64,2013-01-10,NYK,@,IND,L 76-81,240,31,89,.348,27,69,.391,4,20,.200,10,13,.769,76,31,79,.392,26,58,.448,5,21,.238,14,16,.875,81
65,2013-02-01,WAS,@,MEM,L 76-85,240,34,83,.410,29,63,.460,5,20,.250,3,3,1.000,76,35,78,.449,34,71,.479,1,7,.143,14,17,.824,85
66,2013-02-09,CHA,@,PHI,L 76-87,240,27,88,.307,25,72,.347,2,16,.125,20,23,.870,76,39,93,.419,37,77,.481,2,16,.125,7,10,.700,87
1,2013-02-24,MEM,@,BRK,W 76-72,240,32,71,.451,30,64,.469,2,7,.286,10,12,.833,76,29,77,.377,20,56,.357,9,21,.429,5,13,.385,72
2,2013-03-18,LAL,@,PHO,L 76-99,240,29,87,.333,24,65,.369,5,22,.227,13,16,.813,76,42,87,.483,34,67,.507,8,20,.400,7,15,.467,99
3,2012-10-31,DEN,@,PHI,L 75-84,240,33,88,.375,29,70,.414,4,18,.222,5,11,.455,75,30,85,.353,23,60,.383,7,25,.280,17,21,.810,84
4,2012-11-07,ORL,@,MIN,L 75-90,240,28,80,.350,25,68,.368,3,12,.250,16,20,.800,75,34,76,.447,27,56,.482,7,20,.350,15,22,.682,90
5,2012-12-22,CHI,@,ATL,L 75-92,240,32,76,.421,27,62,.435,5,14,.357,6,8,.750,75,38,77,.494,31,58,.534,7,19,.368,9,10,.900,92
6,2013-01-04,IND,@,BOS,L 75-94,240,27,85,.318,23,68,.338,4,17,.235,17,28,.607,75,40,89,.449,36,80,.450,4,9,.444,10,18,.556,94
7,2013-03-03,DET,@,SAS,L 75-114,240,28,86,.326,22,67,.328,6,19,.316,13,18,.722,75,45,89,.506,36,69,.522,9,20,.450,15,20,.750,114
8,2013-04-09,CHA,@,MEM,L 75-94,240,30,80,.375,28,66,.424,2,14,.143,13,18,.722,75,39,82,.476,36,69,.522,3,13,.231,13,20,.650,94
9,2012-11-11,ORL,@,BRK,L 74-82,240,30,84,.357,29,71,.408,1,13,.077,13,18,.722,74,29,78,.372,22,54,.407,7,24,.292,17,25,.680,82
10,2012-11-13,TOR,@,IND,W 74-72,240,26,72,.361,20,60,.333,6,12,.500,16,19,.842,74,24,75,.320,19,60,.317,5,15,.333,19,25,.760,72
11,2012-11-21,DET,@,ORL,L 74-90,240,28,85,.329,25,68,.368,3,17,.176,15,22,.682,74,36,83,.434,31,63,.492,5,20,.250,13,18,.722,90
12,2012-12-10,TOR,@,POR,L 74-92,240,26,74,.351,23,53,.434,3,21,.143,19,21,.905,74,36,89,.404,36,69,.522,0,20,.000,20,22,.909,92
13,2012-12-14,DAL,@,TOR,L 74-95,240,27,69,.391,27,56,.482,0,13,.000,20,23,.870,74,34,84,.405,22,48,.458,12,36,.333,15,22,.682,95
14,2013-02-08,BRK,@,WAS,L 74-89,240,25,76,.329,20,58,.345,5,18,.278,19,32,.594,74,36,80,.450,29,64,.453,7,16,.438,10,11,.909,89
15,2013-02-27,NOH,@,OKC,L 74-119,240,27,77,.351,21,56,.375,6,21,.286,14,18,.778,74,42,76,.553,34,58,.586,8,18,.444,27,28,.964,119
16,2013-03-12,BOS,@,CHA,L 74-100,240,27,66,.409,23,53,.434,4,13,.308,16,25,.640,74,35,77,.455,29,60,.483,6,17,.353,24,30,.800,100
17,2012-11-07,BRK,@,MIA,L 73-103,240,30,80,.375,27,59,.458,3,21,.143,10,17,.588,73,40,77,.519,30,53,.566,10,24,.417,13,16,.813,103
18,2012-12-07,CLE,@,MIN,L 73-91,240,30,87,.345,23,63,.365,7,24,.292,6,9,.667,73,30,70,.429,26,51,.510,4,19,.211,27,35,.771,91
19,2012-12-31,BRK,@,SAS,L 73-104,240,28,74,.378,24,57,.421,4,17,.235,13,17,.765,73,43,73,.589,37,59,.627,6,14,.429,12,16,.750,104
20,2013-01-26,CHI,@,WAS,L 73-86,240,29,71,.408,25,56,.446,4,15,.267,11,12,.917,73,34,79,.430,31,69,.449,3,10,.300,15,19,.789,86
21,2013-02-01,LAC,@,TOR,L 73-98,240,25,72,.347,22,53,.415,3,19,.158,20,31,.645,73,38,81,.469,26,55,.473,12,26,.462,10,17,.588,98
22,2013-03-19,ORL,@,IND,L 73-95,240,28,88,.318,25,73,.342,3,15,.200,14,21,.667,73,34,87,.391,28,64,.438,6,23,.261,21,24,.875,95
23,2012-11-19,ORL,@,ATL,L 72-81,240,31,82,.378,29,72,.403,2,10,.200,8,14,.571,72,34,89,.382,29,64,.453,5,25,.200,8,13,.615,81
24,2012-12-15,WAS,@,MIA,L 72-102,240,27,72,.375,20,52,.385,7,20,.350,11,15,.733,72,40,79,.506,32,52,.615,8,27,.296,14,21,.667,102
25,2012-12-29,DEN,@,MEM,L 72-81,240,29,68,.426,26,52,.500,3,16,.188,11,18,.611,72,36,89,.404,31,70,.443,5,19,.263,4,7,.571,81
26,2013-01-09,PHI,@,TOR,L 72-90,240,29,74,.392,27,64,.422,2,10,.200,12,19,.632,72,39,80,.488,38,69,.551,1,11,.091,11,13,.846,90
27,2013-02-24,CHI,@,OKC,L 72-102,240,25,86,.291,21,68,.309,4,18,.222,18,24,.750,72,36,79,.456,30,62,.484,6,17,.353,24,27,.889,102
28,2013-03-20,PHI,@,LAC,L 72-101,240,29,79,.367,23,59,.390,6,20,.300,8,10,.800,72,41,78,.526,35,58,.603,6,20,.300,13,19,.684,101
29,2012-12-17,CHI,@,MEM,L 71-80,240,28,75,.373,26,64,.406,2,11,.182,13,20,.650,71,30,80,.375,24,69,.348,6,11,.545,14,19,.737,80
30,2013-01-06,WAS,@,MIA,L 71-99,240,29,81,.358,23,60,.383,6,21,.286,7,14,.500,71,38,82,.463,30,61,.492,8,21,.381,15,16,.938,99
31,2013-04-17,UTA,@,MEM,L 70-86,240,25,78,.321,22,67,.328,3,11,.273,17,26,.654,70,34,84,.405,30,71,.423,4,13,.308,14,20,.700,86
32,2012-11-26,CHA,@,OKC,L 69-114,240,23,79,.291,17,57,.298,6,22,.273,17,22,.773,69,40,78,.513,27,51,.529,13,27,.481,21,23,.913,114
33,2013-01-18,SAC,@,MEM,L 69-85,240,29,85,.341,27,75,.360,2,10,.200,9,15,.600,69,34,78,.436,31,71,.437,3,7,.429,14,20,.700,85
34,2013-02-13,CHI,@,BOS,L 69-71,240,27,74,.365,24,57,.421,3,17,.176,12,17,.706,69,28,76,.368,23,61,.377,5,15,.333,10,12,.833,71
35,2012-12-21,WAS,@,DET,L 68-100,240,28,85,.329,26,73,.356,2,12,.167,10,13,.769,68,38,90,.422,28,66,.424,10,24,.417,14,21,.667,100
36,2013-03-01,CHA,@,UTA,L 68-98,240,28,81,.346,23,63,.365,5,18,.278,7,12,.583,68,38,78,.487,33,62,.532,5,16,.313,17,23,.739,98
37,2013-02-13,POR,@,NOH,L 63-99,240,24,74,.324,22,57,.386,2,17,.118,13,13,1.000,63,41,87,.471,36,75,.480,5,12,.417,12,18,.667,99
38,2013-03-11,NYK,@,GSW,L 63-92,240,20,73,.274,15,46,.326,5,27,.185,18,28,.643,63,32,78,.410,21,58,.362,11,20,.550,17,24,.708,92
39,2013-02-04,ORL,@,PHI,L 61-78,240,27,80,.338,26,68,.382,1,12,.083,6,8,.750,61,36,79,.456,33,59,.559,3,20,.150,3,5,.600,78
40,2013-01-14,ATL,@,CHI,L 58-97,240,24,82,.293,22,68,.324,2,14,.143,8,10,.800,58,33,79,.418,27,65,.415,6,14,.429,25,33,.758,97